DephGejcJyCH	姓名#R#性别#R#出生地#R#籍贯#R#身份证号#R#民族#R#政治面貌#R#户口所在地#R#班内学号#R#班级#R#入学年月#R#入学方式#R#就读方式#R#家庭住址#R#QQ号码#R#家庭成员或监护人信息：姓名#R#关系#R#民族#R#工作单位#R#现住址#R#户口所在地#R#家庭成员或监护人的联系电话（手机）#R#是否为监护人#R#联系电话（手机）#R#QQ号码#R#家庭成员或监护人信息：姓名#R#关系
OorHIrtqaqKC	你叫什么
GjKXhpuemeTq	姓名：#R#性别：#R#出生地#R#籍贯#R#身份证号#R#民族#R#政治面貌#R#户口所在地#R#班内学号#R#班级#R#入学年月#R#入学方式#R#就读方式#R#家庭住址#R#QQ号码#R#家庭成员或监护人信息：姓名#R#关系#R#民族#R#工作单位#R#现住址#R#户口所在地#R#家庭成员或监护人的联系电话（手机）#R#是否为监护人#R#联系电话（手机）#R#QQ号码#R#家庭成员或监护人信息：姓名#R#关系
ceiNUUZgqGYN	你的姓名#R#性别#R#手机#R#QQ号#R#微信号#R#是否住校#R#出生日期#R#家长姓名#R#家长电话（手机）#R#家庭住址
RXsYbiPTjoHO	姓名郭华宇#R#性别#R#出生地#R#籍贯#R#身份证号#R#民族#R#政治面貌#R#户口所在地#R#班内学号#R#班级#R#入学年月#R#入学方式#R#就读方式#R#家庭住址#R#QQ号码#R#家庭成员或监护人信息：姓名#R#关系#R#民族#R#工作单位#R#现住址#R#户口所在地#R#家庭成员或监护人的联系电话（手机）#R#是否为监护人#R#联系电话（手机）#R#QQ号码#R#家庭成员或监护人信息：姓名#R#关系
RCWLOoAKtMsW	问题标题16.7050892572
QMruOjUBAhwL	你的手机号码
eqimCtajMZCq	日期#R#地区#R#代理商姓名#R#问题关键词#R#问题描述#R#隶属公司#R#代理商机器#R#KP（关键人）#R#KP联系电话#R#解决方法#R#备注事项#R#未签约原因
MvNqnsWpEcNC	姓名#R#性别#R#手机#R#QQ号#R#微信号#R#是否住校#R#出生日期#R#家长姓名#R#家长电话（手机）#R#家庭住址
PDSaHrWukTAY	姓名#R#性别#R#出生地#R#籍贯#R#身份证号#R#民族#R#政治面貌#R#户口所在地#R#班内学号#R#班级#R#入学年月#R#入学方式#R#就读方式#R#家庭住址#R#QQ号码#R#家庭成员或监护人信息：姓名#R#关系#R#民族#R#工作单位#R#现住址#R#户口所在地#R#家庭成员或监护人的联系电话（手机）#R#是否为监护人#R#联系电话（手机）#R#QQ号码#R#家庭成员或监护人信息：姓名#R#关系
ZlrcjuzbPEfW	123#R#234
RBdkELGaffEQ	分院#R#姓名#R#工号#R#级别#R#是否特殊薪酬
ZtXGpamIeHYi	李成#R#性别
KQsvnItjLmkU	孩子姓名#R#性别#R#出生年月#R#家庭住址#R#出生日期#R#自理能力#R#社交能力概述#R#性格特点和喜好#R#联系电话
egXrLCpCWpcw	日期#R#销售/BD姓名#R#拜访商家名称#R#商家地点#R#隶属公司#R#商家等级#R#KP（关键人）#R#KP联系电话#R#跟进状态#R#未签约原因
YcdZlwfMmwyt	姓名#R#性别#R#出生地#R#籍贯#R#身份证号#R#民族#R#政治面貌#R#户口所在地#R#班内学号#R#班级#R#入学年月#R#入学方式#R#就读方式#R#家庭住址#R#QQ号码#R#家庭成员或监护人信息：姓名#R#关系#R#民族#R#工作单位#R#现住址#R#户口所在地#R#55555#R#家庭成员或监护人的联系电话（手机）#R#是否为监护人#R#联系电话（手机）#R#QQ号码#R#家庭成员或监护人信息：姓名#R#关系
HRiLznpxADcr	姓名#R#性别#R#出生地#R#籍贯#R#身份证号#R#民族#R#政治面貌#R#户口所在地#R#班内学号#R#班级#R#入学年月#R#入学方式#R#就读方式#R#家庭住址#R#QQ号码#R#家庭成员或监护人信息：姓名#R#关系#R#民族#R#工作单位#R#现住址#R#户口所在地#R#家庭成员或监护人的联系电话（手机）#R#是否为监护人#R#联系电话（手机）#R#QQ号码#R#家庭成员或监护人信息：姓名#R#关系
RDaFxHiSBlkf	姓名#R#性别#R#学院#R#年级#R#专业（全称）+班级#R#新/老志愿者#R#QQ#R#电话
dwXYjwLTpdUo	日期#R#销售/BD姓名#R#拜访商家名称#R#商家地点#R#隶属公司#R#商家等级#R#KP（关键人）#R#KP联系电话#R#跟进状态#R#未签约原因
MNBhZGARYRVQ	发现了几处大的不同#R#哪些不同#R#思考下，为什么选择你参加培训学习？
KVOYMIJXJFYk	你的姓名
WWqboytaGnhB	你的手机号码#R#你的手机号码#R#你的身份证号码#R#你的出生年月
TWgysAbiXaZk	CN
UhhOVoRQREDN	姓名#R#性别#R#手机#R#QQ号#R#微信号#R#是否住校#R#出生日期#R#家长姓名#R#家长电话（手机）#R#家庭住址
OtfYjbMiVmAC	姓名刘进雄#R#性别#R#手机#R#QQ号#R#微信号#R#是否住校#R#出生日期#R#家长姓名#R#家长电话（手机）#R#家庭住址
LaBnMpIjkiuA	姓名 学号
AsWMNOEZEdCU	你的姓名#R#班级#R#学号#R#姓名
eZuweygZfFxw	你的姓名#R#什么时候可以提交资料
agqgfWOsSnUH	姓名#R#性别#R#手机#R#QQ号#R#微信号#R#是否住校#R#出生日期#R#家长姓名#R#家长电话（手机）#R#家庭住址
dnsKGsIrdogv	姓名#R#性别#R#联系方式
IdTiAvYVRNMb	你的出生年月
GAZhXPdhVAER	姓名#R#营销员编码#R#证件号码#R#补录日期
DMYSZuKAGeEv	日期#R#客户经理#R#客户姓名#R#客户地址#R#客户情况#R#金额#R#KP（关键人）#R#客户联系电话#R#跟进状态#R#未签约原因
FLAqWzMDQyVu	家庭住址#R#姓名#R#性别#R#手机#R#QQ号#R#微信号#R#是否住校#R#出生日期#R#家长姓名#R#家长电话（手机）#R#家庭住址
KHqNmcDNjYaE	姓名#R#性别#R#出生地#R#籍贯#R#身份证号#R#民族#R#政治面貌#R#户口所在地#R#班内学号#R#班级#R#入学年月#R#入学方式#R#就读方式#R#家庭住址#R#QQ号码#R#家庭成员或监护人信息：姓名#R#关系#R#民族#R#工作单位#R#现住址#R#户口所在地#R#家庭成员或监护人的联系电话（手机）#R#是否为监护人#R#联系电话（手机）#R#QQ号码#R#家庭成员或监护人信息：姓名#R#关系
eTlHHiADMWBg	你的手机号码#R#培训类型#R#你的姓名#R#你的邮箱#R#你的单位
TERJMZzcHnSN	您的姓名#R#公司/团队名称#R#岗位职级#R#岗位职级#R#你的姓名#R#联系电话（手机）
YBMySSjYKcUf	姓名#R#性别#R#出生地#R#籍贯#R#身份证号#R#民族#R#政治面貌#R#户口所在地#R#班内学号#R#班级#R#入学年月#R#入学方式#R#就读方式#R#家庭住址#R#QQ号码#R#家庭成员或监护人信息：姓名#R#关系#R#民族#R#工作单位#R#现住址#R#户口所在地#R#家庭成员或监护人的联系电话（手机）#R#是否为监护人#R#联系电话（手机）#R#QQ号码#R#家庭成员或监护人信息：姓名#R#关系
WWjmDECIqfpe	姓名#R#QQ#R#性别#R#出生日期#R#外战最优视频链接#R#手机#R#微视个人主页链接#R#QQ#R#微信#R#支付宝#R#对于XX社的看法和建议#R#QQ#R#外战最优视频链接#R#意愿部门
CUiTYLNAXhcy	您的姓名#R#优秀事迹说明（针对上一题选择的人进行描述）#R#您支持的员工（必选2人）
byxxyGgrVtTU	姓名#R#部门#R#手机号码#R#邮箱#R#课程选择#R#岗位#R#方便参加课程时间#R#近期意向学习内容#R#其他建议
ecmWqfSUIpNp	姓名#R#性别#R#出生日期#R#学院#R#手机号码#R#QQ#R#为什么会考虑加入XX社#R#觉得自己加入XX社的优势#R#对于XX社的看法和建议#R#QQ#R#自我评价#R#意愿部门
ZBehkOpgGrvl	
EFjMGYpauMRF	你的手机号码#R#你的姓名#R#你的手机号码#R#部门#R#你的学历
AIOJNYxmXaqo	开票日期#R#发票号：#R#货物名称#R#型号#R#单位#R#数量#R#单价#R#KP联系电话#R#跟进状态#R#备注
ByXxvYlBjcaO	姓名#R#性别#R#手机#R#QQ号#R#微信号#R#是否住校#R#出生日期#R#家长姓名#R#家长电话（手机）#R#家庭住址
IvLAICzqrcfb	你的姓名（真实姓名）
biYMKOKDXeVf	你的姓名
ECOMFEnnBNpI	学生姓名
DXhLcISVRNZd	姓名#R#性别#R#出生地#R#籍贯#R#身份证号#R#民族#R#政治面貌#R#户口所在地#R#班内学号#R#班级#R#入学年月#R#入学方式#R#就读方式#R#家庭住址#R#QQ号码#R#家庭成员或监护人信息：姓名#R#关系#R#民族#R#工作单位#R#现住址#R#户口所在地#R#家庭成员或监护人的联系电话（手机）#R#是否为监护人#R#联系电话（手机）#R#QQ号码#R#家庭成员或监护人信息：姓名#R#关系
PbWulzyxrqZn	您的姓名#R#公司/团队名称#R#岗位职级#R#岗位职级#R#联系电话（手机）
GkVIsukuqgEq	姓名#R#年前是否辞职#R#是否留年值班#R#初步回家日期#R#初步返岗日期
VSquuQBZRROy	你的姓名#R#你的身份证号码#R#首套住房利息支出#R#房租支出#R#子女教育费用支出#R#赡养老人支出#R#大病支出#R#个人继续教育
HglZtONbGqpx	你的性别
FYBUNzqUOQdI	表达是否清晰？#R#听完是否能明白分享者所说的东西？#R#示例是否恰当，是否充分运用概念去解释、应用？#R#对你有没有启发？#R#你对分享者有其他建议吗？#R#分享时间#R#分享主题#R#示例是否恰当，是否充分运用概念去解释、应用？
OHqxcWAafBxj	你的姓名#R#你的手机号码
YKghcllqRoKz	你的姓名#R#你的学号#R#当前所在部门及职务#R#新媒体中心网编部部长、青协外联部部长等)#R#志愿服务工时总数#R#个人所获荣誉#R#曾获挑战杯省级二等奖(省级)、校十佳歌手(校级)、校三好学生(校级)、院辩论赛冠军(院级)及其他院级奖项共十余项)#R#任职期间对18级干事的培养#R#教干事Excel软件操作、教干事ps海报制作、教干事微信平台设计及运营管理。)#R#任期内本人所负责的工作述列(评选重点)#R#按项目分点论述，尽量写的详细工整，按照重要性排序，重要的工作写在前面。不可以写部门内自己未负责的工作。)#R#个人所获荣誉#R#挑战杯省二等奖(省级)、校园十佳歌手(校级)、校优秀学生干部(校级)、辩论赛优秀辩手(院级)及其他院级奖项共xx项)#R#未来工作规划#R#其他需要补充的事
RKEqqrAYofsY	姓名#R#性别#R#出生地#R#籍贯#R#身份证号#R#民族#R#政治面貌#R#户口所在地#R#班内学号#R#班级#R#入学年月#R#入学方式#R#就读方式#R#家庭住址#R#QQ号码#R#家庭成员或监护人信息：姓名#R#关系#R#民族#R#工作单位#R#现住址#R#户口所在地#R#家庭成员或监护人的联系电话（手机）#R#是否为监护人#R#联系电话（手机）#R#QQ号码#R#家庭成员或监护人信息：姓名#R#关系
dMNNfixckXNt	姓名#R#性别#R#手机#R#QQ号#R#微信号#R#是否住校#R#出生日期#R#家长姓名#R#家长电话（手机）#R#家庭住址
WXbmCOefkwOd	你的姓名#R#学号#R#文体活动#R#创新创业#R#技能特长#R#思想成长#R#志愿公益#R#工作履历#R#实践实习#R#半个月内总分
HSXQvllWpiUP	学校
UygeYLzrmEVk	你的班级#R#你的姓名#R#你的爱好#R#参加社团的原因
HDJarYSFvInl	你的姓名
QwUnfxkmhGwy	你的姓名#R#下面关于导体电阻的说法，正的是( )#R#现有两个标模糊、额定电压都是220v，但额定功率相差较大的白炽灯泡，怎样判断哪一盏灯的额定功率大？请说出两种
DeDCQyrVqNHv	投票测试2
bDqgfhLmtkCL	工会。按照国家行政区划在县级行政区域以上成立的各级总工会，以及同行业或相近行业成立的符合法人单位条件的产业工会作为社会团体法人单位；各单位内部工会组织不单独作为普查对象。#R#乡镇政府和党委。乡镇政府和党委，如果分别有单独的“三定方案”，且会计上能够单独核算资产，则分别作为法人单位；否则，作为一个法人单位，单位名称填写为“某某某乡（镇）人民政府（党委）”。#R#.乡镇中小学。若领取法人证照，作为单独的法人单位；若未领取法人证照，但能提供收入或者支出等相关资料，作为产业活动单位；#R#乡镇所属的站、所。乡镇所属的站、所按证照确定单位类型，未领取证照的，不单独作为普查对象。#R#村和社区医疗服务等单位。若领取市场监管或民政部门的法人证照，作为单独的法人单位。若未在市场监管、民政部门领取证照，仅领取卫生部门颁发的许可证，如能提供收入或者支出等相关资料，作为个体经营户；#R#普查员如何处理许可证与登记注册证照的关系#R#跨地区水利系统的分支机构。凡跨县级以上行政区划的流域水利管理机构的县级及以上分支机构（河务局、处、所）视同法人单位。#R#彩票销售网点。彩票销售网点是各级彩票中心下属的彩票投注站点，一般依附于其他单位存在，不作为单独的单位填报普查表。#R#未领取证照的从事建筑业活动的个体经营者。在城镇、乡村从事建筑业活动的个体劳动者（如：泥瓦工、木工、油漆工、水电工等），
HXCvzBtgiohV	联系方式（QQ、微信、电话、邮件均可）#R#你所用EXSI版本？#R#你的硬件配置#R#是否使用显卡直通？#R#是否使用PCI或PCI-E直通？#R#是否使用USB直通？#R#是否使用硬盘直通？#R#是否在U盘安装EXSI？？#R#你试过不能安装exsi的主板和CPU及其它硬件#R#其它说明
dkYAfrbKTVqU	姓名#R#性别#R#出生日期#R#学院#R#手机号码#R#QQ#R#为什么会考虑加入XX社#R#觉得自己加入XX社的优势#R#对于XX社的看法和建议#R#QQ#R#自我评价#R#意愿部门
OsjIplEZCGDm	您的姓名#R#应聘职位#R#联系#R#岗位职级#R#联系电话（手机）
LnbVfknUrLIi	政治面貌#R#入团时间#R#你的姓名#R#你的手机号码#R#你的身份证号码
PgQuDzTbkPfB	姓名#R#班级#R#手机号码
fpMTHTJRvUpA	教师名称#R#教师系统#R#教师等级#R#入职时间#R#你的手机号码
bbhFHwResxkT	考试日期#R#//www.cnpctest.com/dwdm.htm)#R#单位代码（3位数字）#R#//www.cnpctest.com/dwdm.htm)#R#单位名称#R#英语水平考试人数#R#英语900句考试人数#R#俄语水平考试人数#R#俄语900句考试人数#R#西语水平考试人数（只有2、5、8、11这四个月组织西语水平考试）#R#西语300句考试人数（只有2、5、8、11这四个月组织组织西语300句考试）#R#法语水平考试人数（只有2、5、8、11这四个月组织法语水平考试）#R#其它小语种考试人数（只有2、5、8、11这四个月组织其它小语种考试）
NTlcELKwjpSY	姓名#R#性别#R#出生日期#R#学院#R#手机号码#R#QQ#R#为什么会考虑加入XX社#R#觉得自己加入XX社的优势#R#对于XX社的看法和建议#R#QQ#R#自我评价#R#意愿部门
VcPcYoBRuQYz	姓名#R#性别#R#出生地#R#籍贯#R#身份证号#R#民族#R#政治面貌#R#户口所在地#R#班内学号#R#班级#R#入学年月#R#入学方式#R#就读方式#R#家庭住址#R#QQ号码#R#家庭成员或监护人信息：姓名#R#关系#R#民族#R#工作单位#R#现住址#R#户口所在地#R#家庭成员或监护人的联系电话（手机）#R#是否为监护人#R#联系电话（手机）#R#QQ号码#R#家庭成员或监护人信息：姓名#R#关系
UyCcOOMNcDFH	喜欢什么颜色?喜欢什么，想要什么？
ArZhsgRpnHqF	学生姓名#R#性别#R#学生第一监护人身份#R#学生第一监护人身份证号码#R#学生第一监护人手机号码#R#学生第二监护人姓名#R#学生第二监护人身份#R#学生第二监护人手机号码#R#学生第三监护人姓名#R#学生第三监护人身份#R#学生第三监护人手机号码#R#出生地#R#籍贯#R#身份证号#R#民族#R#政治面貌#R#户口所在地#R#学生学号#R#班级#R#入学年月#R#入学方式#R#就读方式#R#家庭住址#R#QQ号码#R#学生第一监护人姓名#R#关系#R#民族#R#工作单位#R#现住址#R#户口所在地#R#家庭成员或监护人的联系电话（手机）#R#是否为监护人#R#联系电话（手机）#R#QQ号码#R#家庭成员或监护人信息：姓名#R#关系
IbICyutTGBTC	所在学院#R#姓名#R#学号#R#联系方式#R#联系方式#R#专业班级#R#临床1801)
WXoipyvmYMWq	是否为新注册的全民账号#R#姓名#R#手机#R#全民小视频账号昵称#R#微信#R#支付宝#R#民族#R#政治面貌#R#户口所在地#R#班内学号#R#班级#R#入学年月#R#入学方式#R#就读方式#R#家庭住址#R#QQ号码#R#家庭成员或监护人信息：姓名#R#关系#R#民族#R#工作单位#R#现住址#R#户口所在地#R#家庭成员或监护人的联系电话（手机）#R#是否为监护人#R#联系电话（手机）#R#QQ号码#R#家庭成员或监护人信息：姓名#R#关系
ModuNHyhVgUF	你的姓名#R#你2019年所订的杂志有哪些？
IgUQbgsEeboa	姓名#R#性别#R#出生地#R#籍贯#R#身份证号#R#民族#R#政治面貌#R#户口所在地#R#班内学号#R#班级#R#入学年月#R#入学方式#R#就读方式#R#家庭住址#R#妈妈电话#R#QQ号码#R#家庭成员或监护人信息：姓名#R#关系#R#民族#R#工作单位#R#现住址#R#户口所在地#R#家庭成员或监护人的联系电话（手机）#R#是否为监护人#R#联系电话（手机）#R#QQ号码#R#家庭成员或监护人信息：姓名#R#关系
TnuWcirgsmAr	王明宏#R#学生1#R#学生2
VoPgFbOOfNWK	你的姓名
MGqFWDHQmRlD	姓名#R#性别#R#出生地#R#籍贯#R#身份证号#R#民族#R#政治面貌#R#户口所在地#R#班内学号#R#班级#R#入学年月#R#入学方式#R#就读方式#R#家庭住址#R#QQ号码#R#家庭成员或监护人信息：姓名#R#关系#R#民族#R#工作单位#R#现住址#R#户口所在地#R#家庭成员或监护人的联系电话（手机）#R#是否为监护人#R#联系电话（手机）#R#QQ号码#R#家庭成员或监护人信息：姓名#R#关系
YmKGYrGVRERe	日期#R#提交时间#R#所拍免单品类#R#订单编号#R#销售/BD姓名#R#拜访商家名称#R#商家地点#R#隶属公司#R#商家等级#R#KP（关键人）#R#KP联系电话#R#跟进状态#R#你的姓名#R#未签约原因
bgFszUcxcYAp	姓名#R#性别#R#手机#R#QQ号#R#出生年月#R#毕业设计小组人数#R#QQ邮箱#R#微信号#R#毕业选题#R#是否住校#R#出生日期#R#家长姓名#R#家长电话（手机）#R#家庭住址
JxIMYQlnCcbn	您的姓名#R#公司/团队名称#R#岗位职级#R#岗位职级#R#联系电话（手机）
TLAjtukohQLS	您的免单产品是#R#订单编号
fBKEXnxFOCxC	姓名
ejCbXESTzluq	姓名#R#性别#R#出生地#R#籍贯#R#身份证号#R#民族#R#政治面貌#R#户口所在地#R#班内学号#R#班级#R#入学年月#R#入学方式#R#就读方式#R#家庭住址#R#QQ号码#R#家庭成员或监护人信息：姓名#R#关系#R#民族#R#工作单位#R#现住址#R#户口所在地#R#家庭成员或监护人的联系电话（手机）#R#是否为监护人#R#联系电话（手机）#R#QQ号码#R#家庭成员或监护人信息：姓名#R#关系
QXOxoEByuqti	你的学号+姓名#R#根据第2周的学习目标把“我不行”的自动化思维更新为“我试试”，制定你自己的行动力肖目标#R#除了你自己定的小目标，你还想在哪些训练营学习上做突破和尝试？#R#一天当中的相对空闲的时间端（方便班班跟你私聊链接哦）#R#00#R#00-9#R#00#R#00-13#R#00#R#00-14#R#00#R#00#R#00-21#R#00#R#00-22：00#R#00-23#R#00#R#写下你对下一周航行的期待
cJAJqxXShVZr	起程地址#R#到达地点#R#长途#R#地铁#R#公交#R#摩的#R#的士#R#里程#R#住宿#R#过路费
bgpHsvQPmSdk	姓名#R#性别#R#最喜欢的音乐#R#最喜欢的食物#R#身份证号#R#民族#R#政治面貌#R#户口所在地#R#班内学号#R#班级#R#入学年月#R#入学方式#R#就读方式#R#家庭住址#R#QQ号码#R#家庭成员或监护人信息：姓名#R#关系#R#民族#R#工作单位#R#现住址#R#户口所在地#R#家庭成员或监护人的联系电话（手机）#R#是否为监护人#R#联系电话（手机）#R#QQ号码#R#家庭成员或监护人信息：姓名#R#关系
MbuGUtdFexsD	主题清晰度（100分满分）#R#声音洪亮度（100分满分）#R#表达自信度（100分满分）#R#演讲形象（100满分）（站姿、眼神）#R#互动性（100分满分）（眼神互动、邀请听众回答）#R#演讲的吸引力（100分满分）
ZGsJQZTMaPBj	出差起始日期#R#出差结束日期#R#出差目的地#R#出差事由#R#车费#R#住宿费#R#差旅性质
NDwFwucMQbPI	姓名#R#性别#R#年级#R#专业#R#联系方式
WjgxWRXflCxp	你的姓名
YOrawjUBFwdI	你的性别
YwIsmZQRtPWj	你的姓名
CdcCFuNogMXR	姓名#R#性别#R#出生地#R#籍贯#R#身份证号#R#民族#R#政治面貌#R#户口所在地#R#班内学号#R#班级#R#入学年月#R#入学方式#R#就读方式#R#家庭住址#R#QQ号码#R#家庭成员或监护人信息：姓名#R#关系#R#民族#R#工作单位#R#现住址#R#户口所在地#R#家庭成员或监护人的联系电话（手机）#R#是否为监护人#R#联系电话（手机）#R#QQ号码#R#家庭成员或监护人信息：姓名#R#关系
aBmscFDuxIkg	姓名#R#部门#R#手机号码#R#邮箱#R#课程选择#R#岗位#R#方便参加课程时间#R#近期意向学习内容#R#其他建议
KsifPgHgywqY	姓名#R#性别#R#手机#R#QQ号#R#微信号#R#是否住校#R#出生日期#R#家长姓名#R#家长电话（手机）#R#家庭住址
SLXBnUnwotmz	姓名#R#性别#R#手机#R#QQ号#R#微信号#R#是否住校#R#出生日期#R#家长姓名#R#家长电话（手机）#R#家庭住址
NbuAAaPcxCIp	企业名称#R#联系方式#R#企业邮箱
DoGtumYpEuSK	你的姓名#R#你的手机号码#R#你的身份证号码#R#你的工号
YXYFOYWQrniP	活动名称：#R#参与社团：#R#活动主办单位：#R#活动协办单位：#R#活动日期#R#备注：
YcMeclWOaqDm	姓名#R#性别#R#手机#R#QQ号#R#微信号#R#是否住校#R#出生日期#R#家长姓名#R#家长电话（手机）#R#家庭住址
YVQWdCtFsGnU	你的姓名#R#班级#R#是否同意举办这次联谊会#R#意见
AjPQQDjqZNOJ	你的姓名#R#存在的问题#R#改进的的措施
eYXWYCjfqmhk	序号#R#免单日期#R#免单品类#R#免单订单号#R#免单负责人#R#免单负责人#R#提交人#R#免单金额
QufJhCBIJOEm	姓名#R#性别#R#手机#R#QQ号#R#微信号#R#是否住校#R#出生日期#R#家长姓名#R#家长电话（手机）#R#家庭住址
deXwQQwcEPmW	第二志愿专业方向？#R#第一志愿专业方向？#R#你本年度综测排名多少？#R#你的学号#R#你的姓名
HNMORTxfnejb	你的手机号码#R#你的姓名#R#你的手机号码
KykFdumVdHuw	是否同意此次报销申请？
AyeKSiOgNWYw	姓名#R#性别#R#手机#R#QQ号#R#微信号#R#是否住校#R#出生日期#R#家长姓名#R#家长电话（手机）#R#家庭住址
VVeOkKrjkNnD	你的姓名
AFZMbljQhyGk	你的姓名#R#学号
dQdPmcBPevQe	你
MWBOlYIYThcq	主题清晰度（100分满分）#R#声音洪亮度（100分满分）#R#表达自信度（100分满分）#R#演讲形象（100满分）（站姿、眼神）#R#互动性（100分满分）（眼神互动、邀请听众回答）#R#演讲的吸引力（100分满分）
FkkdqPJrGvHo	收件公司#R#收件人#R#收件电话#R#收件手机#R#收件地址#R#备注
XVKxoBSChglJ	姓名#R#性别#R#手机#R#QQ号#R#微信号#R#是否住校#R#出生日期#R#家长姓名#R#家长电话（手机）#R#家庭住址
bUVTXDgSTxdn	你的姓名#R#你的姓名#R#教材类型#R#学号
foxfjJhfULgf	姓名#R#性别#R#出生地#R#籍贯#R#身份证号#R#民族#R#政治面貌#R#户口所在地#R#班内学号#R#班级#R#入学年月#R#入学方式#R#就读方式#R#家庭住址#R#QQ号码#R#家庭成员或监护人信息：姓名#R#关系#R#民族#R#工作单位#R#现住址#R#户口所在地#R#家庭成员或监护人的联系电话（手机）#R#是否为监护人#R#联系电话（手机）#R#QQ号码#R#家庭成员或监护人信息：姓名#R#关系
AhufaoWbqgYl	你的姓名#R#你的手机号码#R#你的性别
ESsdSIuGCtjJ	你的姓名#R#你的手机号码#R#你的身份证号码#R#单行文本测试#R#多行文本测试#R#多选测试#R#单选测试#R#下拉选择测试#R#日期测试#R#时间长测试
WOnscaRFQlhq	日期#R#销售/BD姓名#R#拜访商家名称#R#商家地点#R#隶属公司#R#商家等级#R#KP（关键人）#R#KP联系电话#R#跟进状态#R#未签约原因
LwdqyqxvaNVm	您的姓名#R#公司/团队名称#R#岗位职级#R#岗位职级#R#联系电话（手机）
NErwlsusnplf	Chinese name（中文姓名，请填写汉字）#R#Passport Name（护照姓名，请填写英文）#R#Passport number（护照号码，确认护照有效期1年以上）#R#Gender（性别）#R#出生地#R#Date of Birth（出生日期）#R#学校中文名称（请用中文填写）#R#National ID（身份证号）#R#Team role（队伍角色）#R#政治面貌#R#School name（学校英文名称，请用英文填写）#R#Email (请填常用邮箱，注册FRC账号)#R#Telephone Number（中国大陆联系电话）#R#Parent Name（家长或监护人姓名，紧急联系时使用）#R#Parent Telephone Number （监护人电话，紧急联系使用）#R#备注：队员有其它信息，请填在这里。（选填）#R#Parent Email (请填常用邮箱，注册家长FRC账号)#R#是否参加美国比赛（1个行程费用约25000元人民币，不含美国签证费）#R#是否持有美国有效签证？#R#入队意向调查#R#备注：队员有其它信息，请填在这里。（选填）#R#QQ号码#R#家庭成员或监护人信息：姓名#R#关系#R#民族#R#工作单位#R#现住址#R#户口所在地#R#家庭成员或监护人的联系电话（手机）#R#是否为监护人#R#联系电话（手机）#R#QQ号码#R#家庭成员或监护人信息：姓名#R#关系
YnQHIsGXWBLQ	学员姓名（中文）#R#学员的性别#R#学员的出生年月日（阳历）#R#父亲手机号码#R#母亲手机号码#R#学员所在全日制学校/幼儿园#R#学员的年级#R#家庭住址（盐湖区*小区/夏县*小区）#R#入学桑尼的时间#R#父亲工作单位#R#母亲工作单位#R# 学员到校离校方式#R#你的姓名
dpofGtusAcXl	姓名#R#性别#R#手机#R#QQ号#R#微信号#R#是否住校#R#出生日期#R#家长姓名#R#家长电话（手机）#R#家庭住址
dKdRkWGFCZWq	姓名#R#性别#R#手机#R#座号#R#微信号#R#是否住校#R#出生日期#R#家长姓名#R#家长电话（手机）#R#家庭住址
YDExqbnIlHtO	你的姓名#R#你的手机号码#R#你的身份证号码
eoshrIHQRMPA	姓名#R#活动名称地点#R#时间
CjuiLEyUZXig	姓名#R#性别#R##R#你的生活费来源最主要是#R##R#父母给你生活费的方式是#R##R#你在校期间的月平均消费#R##R#每月平均用于校内三餐的费用约为#R##R#每月平均用于零食及校外饮食（含外卖）的费用约#R##R#你去高档场所（如星巴克）消费吗？#R#每月平均用于购置衣服的费用#R##R#你在护肤、化妆品上，平均每月花费多少？#R#你在淘宝、唯品会等网站上购买东西的月频率一般是#R##R#你通常会在以下哪些项目上充钱？#R#你平均一个月的手机通讯费约#R##R#请你评价一下自己的消费支出的情况#R##R#每月平均购买日用品（卫生纸、洗衣粉）的费用#R##R#你每月平均与同学或朋友聚会的费用为#R##R#入学方式#R#就读方式#R#家庭住址#R#QQ号码#R#家庭成员或监护人信息：姓名#R#关系#R#民族#R#工作单位#R#现住址#R#户口所在地#R#家庭成员或监护人的联系电话（手机）#R#是否为监护人#R#联系电话（手机）#R#QQ号码#R#家庭成员或监护人信息：姓名#R#关系
QQlybrwcyLqH	在晴朗的冬日，用塑料梳子梳干燥的头发，头发会越梳越蓬松，主要原因是（ ）#R#如图15-9所示的电路中，闭合开关后三个电流表A1、A2、A示数分别为I1、I2、I，已知I=0.6A，I1=0.4A，则通过灯L2的电流是多少安？
TtkERuELOBxf	彭枧贵#R#袁
MsUNMuTyUsAk	主题清晰度（100分满分）#R#声音洪亮度（100分满分）#R#表达自信度（100分满分）#R#演讲形象（100满分）（站姿、眼神）#R#互动性（100分满分）（眼神互动、邀请听众回答）#R#演讲的吸引力（100分满分）
UNbNZEGzNktH	姓名#R#数量#R#物品名
EMiJQCOKrqlK	你的姓名#R#年级#R#学号
AKLFqqWUGzRU	姓名#R#性别#R#手机#R#QQ号#R#微信号#R#是否住校#R#出生日期#R#家长姓名#R#家长电话（手机）#R#家庭住址
fOSVRgLGiHUa	目的地#R#网址链接#R#手机#R#QQ号#R#微信号#R#是否住校#R#出生日期#R#家长姓名#R#家长电话（手机）#R#网址链接
TNgDmsDWVaFM	圈名#R#性别#R#出生日期#R#学院#R#手机号码#R#QQ#R#为什么会考虑加入XX社#R#觉得自己加入XX社的优势#R#对于XX社的看法和建议#R#QQ#R#自我评价#R#意愿部门
RRrXqzQBKcIG	订单编号#R#支付宝账号
eaHtIYkrOWdN	你的姓名#R#你的手机号码
FhVXpXRcLcUH	白桦#R#资源统筹部#R#15877681170#R#邮箱#R#课程选择#R#岗位#R#方便参加课程时间#R#近期意向学习内容#R#其他建议
TqRQgeewGFrd	你的手机号码#R#地址#R#你的邮箱
ESuAWEPiuqDS	姓名#R#性别#R#手机#R#QQ号#R#微信号#R#是否住校#R#出生日期#R#家长姓名#R#家长电话（手机）#R#家庭住址
UANAfnvrjnvy	你的姓名#R#你的服装尺寸
ZZIqBZAqAIdj	你的群内昵称#R#你今年去电影院看了哪几部电影#R#其中最差的一部是？#R#为什么？#R#你的生理性别是？
RKXMbFtSWbGL	昵称#R#性别#R#出生日期#R#QQ#R#籍贯#R#QQ#R#为什么会考虑加入本社#R#觉得自己加入本社的优势#R#籍贯#R#对于本社的看法和建议#R#QQ#R#自我评价#R#意愿部门
MBJtaSuuDJBY	你的手机号码
bFPyQfqvwvQK	你的手机号码
VDFsjAbByDah	姓名#R#性别#R#出生地#R#籍贯#R#身份证号#R#民族#R#政治面貌#R#户口所在地#R#班内学号#R#班级#R#入学年月#R#入学方式#R#就读方式#R#家庭住址#R#QQ号码#R#家庭成员或监护人信息：姓名#R#关系#R#民族#R#工作单位#R#现住址#R#户口所在地#R#家庭成员或监护人的联系电话（手机）#R#是否为监护人#R#联系电话（手机）#R#QQ号码#R#家庭成员或监护人信息：姓名#R#关系
DPecLNRFmpKL	你是#R#你（孩子）的姓名是#R#你（孩子）的年龄是#R#你（孩子）正在使用的教材/正在学习的曲目是#R#你（孩子）有哪些音乐活动的经历（参加过什么演出/比赛，用什么曲目，取得什么成果，可以填“无”）
QYmpKjKIiCcb	姓名#R#出生年月
UmDmRylBNuvz	你的姓名#R#你的姓名#R#你的姓名#R#你的手机号码
QKxcggexAVAJ	姓名#R#性别#R#出生日期#R#学院#R#手机号码#R#QQ#R#为什么会考虑加入XX社#R#觉得自己加入XX社的优势#R#对于XX社的看法和建议#R#QQ#R#自我评价#R#意愿部门
EKoiNsvypQTd	你的姓名#R#姓名#R#联系电话#R#银行卡号(中国银行)#R#开户行#R#中国银行#R#东圃支行)#R#身份证号码
SZxBeWPaODTf	你认为自己对于基本的法律法规了解吗#R#你认为传统的观念“权大于法”正确吗？#R#你认为学校关于法律的教育完善吗？#R#你认为增强大学生的法律意识重要吗？#R#你对于大学生增强法律意识有什么建议吗？
EfGsVzfkQnYR	夏利#R#小屋
GVzBtDnubWCp	报单类型#R#姓名#R#备注#R#推荐人电话#R#推荐人姓名#R#政治面貌#R#日期#R#性别#R#年龄#R#本人手机号#R#身份证号#R#QQ#R#开户行名称#R#身份证地址#R#现住地址#R#QQ#R#农行卡号#R#意愿部门
ULZeYAOnxqVZ	姓名#R#性别#R#手机#R#QQ号#R#微信号#R#是否住校#R#出生日期#R#家长姓名#R#家长电话（手机）#R#家庭住址
KXKcRjNicdFs	姓名贾孟彬#R#性别男#R#出生地#R#籍贯#R#身份证号#R#民族#R#政治面貌#R#户口所在地#R#班内学号#R#班级#R#入学年月#R#入学方式#R#就读方式#R#家庭住址#R#QQ号码#R#家庭成员或监护人信息：姓名#R#关系#R#民族#R#工作单位#R#现住址#R#户口所在地#R#家庭成员或监护人的联系电话（手机）#R#是否为监护人#R#联系电话（手机）#R#QQ号码#R#家庭成员或监护人信息：姓名#R#关系
MiNftcBsmQRL	你的姓名#R#你的性别#R#你的民族
DfoYVJKEeSkX	你的姓名#R#你的提案#R#你的姓名
RwbvyjQktNJn	你的姓名#R#你的手机号码
XOHrfZpHPTnf	你的姓名#R#你的身份证号码#R#你的身份证号码#R#你的服装尺寸
WUFfHebUDIbB	学号#R#姓名#R#所属导师#R#拟撰写论文的题目
SvYVBFStwYSI	你的姓名#R#您的学号#R#您的入学日记
NNGjcOZJaRaL	家长姓名#R#电话号码
GJsaWBudYJXF	姓名#R#性别#R#手机#R#QQ号#R#微信号#R#是否住校#R#出生日期#R#家长姓名#R#家长电话（手机）#R#家庭住址
KhhMggMQbPfW	你的姓名
JQPanGZgchiJ	百度ID#R#事项类别#R#需要处理事项
UpmCDNVJvzCJ	你的网名#R#是否有属于自己的QQ群#R#填写你的QQ群的群号#R#填写你的网名#R#填写你的QQ账号#R#入团方式#R#你的群规模（群人数）为多少#R#你最擅长的技术是什么#R#申请完成#R#加入官方群审核
YhcCMxsaSWsh	用户成效好，客户满意度高#R#用户成效好，客户满意度一般#R#用户成效一般，客户满意度高#R#用户成效一般，客户满意度一般#R#用户成效差，客户满意度高#R#用户成效差，客户满意度低#R#用户成效好，客户满意度低
IcgkfYpASMBL	姓名许亚利#R#性别#R#手机#R#QQ号#R#微信号#R#是否住校#R#出生日期#R#家长姓名#R#家长电话（手机）#R#家庭住址
LQhvhGIhBntZ	姓 名#R#中文姓拼音#R#中文名拼音#R#学校#R#班级#R#认证方向#R#手机号#R#身份证号#R#邮 箱#R#身份证号
NgAFGCIfBRZs	您的姓名#R#班级#R#请假时间#R#请假理由#R#公司/团队名称#R#岗位职级#R#岗位职级#R#联系电话（手机）
LhgcEaTCyUQe	参加正式打码的工号#R#支付宝账号
SGpKzNGKGKYS	日期#R#销售/BD姓名#R#拜访商家名称#R#商家地点#R#隶属公司#R#商家等级#R#KP（关键人）#R#KP联系电话#R#跟进状态#R#未签约原因
HtNqPAUFuWMk	你的姓名或单位名字#R#联系电话#R#你现在的电视是那家营运商提供的#R#如是多台电视的话，请详细说明（包含费用）#R#你的电视是智能电视吗？#R#你现在用哪家营运商的宽带？#R#如是多条宽带的话，请详细说明（包含费用）#R#你现在宽带速度？#R#你现在用哪家营运商的手机？#R#你希望装1台以上电视吗？#R#你家或单位有固话码？#R#其它说明
QHRyaoEsxPdd	产品逻辑（满分10）#R#产品吸引力（满分20）#R#产品是否考虑到地域性（满分7）#R#产品特点是否鲜明（满分8）#R#队员语言表达能力（满分15）#R#团队配合协作能力（满分20）#R#答疑能力（满分20）#R#口号创意（满分10）
BYVSQJfAJjpp	姓名（CN）#R#部门#R#QQ
ZtAdXUOvhDlM	你的手机号码#R#你的姓名
AIphJdXYLVqQ	捐款对象单位/姓名#R#捐款人联系方式#R#捐款金额#R#备注#R#捐款对象类型
OgxaLJLOfhqt	时间表
YPzjkDbtBgbl	超过三次转介绍的客户#R#两次转介绍的客户#R#一次转介绍的客户#R#参加续费活动的客户
OioeJdyYhFuK	姓名#R#性别#R#出生日期#R#学院#R#手机号码#R#QQ#R#为什么会考虑加入XX社#R#觉得自己加入XX社的优势#R#对于XX社的看法和建议#R#QQ#R#自我评价#R#意愿部门
DORdVvhoeGlN	姓名#R#性别#R#出生地#R#籍贯#R#身份证号#R#民族#R#政治面貌#R#户口所在地#R#班内学号#R#班级#R#入学年月#R#入学方式#R#就读方式#R#家庭住址#R#QQ号码#R#家庭成员或监护人信息：姓名#R#关系#R#民族#R#工作单位#R#现住址#R#户口所在地#R#家庭成员或监护人的联系电话（手机）#R#是否为监护人#R#联系电话（手机）#R#QQ号码#R#家庭成员或监护人信息：姓名#R#关系
fgOyIzAYyygt	你的手机号码
NVRuORDUJrZM	你的姓名#R#你的手机号码#R#你的身份证号码#R#你的性别#R#你的出生年月#R#你的学历
LfylvSUVlVBQ	日期#R#星期#R#班级#R#教室#R#值班党员#R#实到人数#R#应到人数#R#晚自习综合情况
JhMkTfQUqQjP	日期20181210#R#销售/BD姓名#R#拜访商家名称#R#商家地点#R#隶属公司#R#商家等级#R#KP（关键人）#R#KP联系电话#R#跟进状态#R#未签约原因
McOGDtjMaljU	姓名#R#手机号码
RSULPuZTfiZX	宝贝的名字
WNfRCrDrqmSt	买买提明，阿布都克力木#R#性别#R#出生地#R#籍贯#R#身份证号#R#民族#R#政治面貌#R#户口所在地#R#班内学号#R#班级#R#入学年月#R#入学方式#R#就读方式#R#家庭住址#R#QQ号码#R#家庭成员或监护人信息：姓名#R#关系#R#民族#R#工作单位#R#现住址#R#户口所在地#R#家庭成员或监护人的联系电话（手机）#R#是否为监护人#R#联系电话（手机）#R#QQ号码#R#家庭成员或监护人信息：姓名#R#关系
YixMGjGUyfkW	您的姓名#R#公司/团队名称#R#岗位职级#R#岗位职级#R#联系电话（手机）
SbYaeVSOYLAi	姓名#R#性别#R#出生地#R#籍贯#R#身份证号#R#民族#R#政治面貌#R#户口所在地#R#班内学号#R#班级#R#入学年月#R#入学方式#R#就读方式#R#家庭住址#R#QQ号码#R#家庭成员或监护人信息：姓名#R#关系#R#民族#R#工作单位#R#现住址#R#户口所在地#R#家庭成员或监护人的联系电话（手机）#R#是否为监护人#R#联系电话（手机）#R#QQ号码#R#家庭成员或监护人信息：姓名#R#关系
ZfwwfhpXiYTy	学号#R#姓名#R#民族#R#群众/团员(预备党员和党员不用填)#R#团干职务(团干填组织委、团支书、宣传委)#R#第几期积极分子#R#第几期积极分子#R#第几期发展对象#R#是否预备党员
HkOBnOvXLatF	姓名#R#性别#R#手机#R#QQ号#R#微信号#R#是否住校#R#出生日期#R#家长姓名#R#家长电话（手机）#R#家庭住址
PyjKOWWIZOTD	姓名#R#性别#R#手机号#R#QQ号#R#微信号#R#是否住校#R#出生日期#R#家长姓名#R#家长电话（手机）#R#家庭住址
DTdCXqzPZoTu	姓名（如：张三）#R#联系地址（各地配送中心地址或青岛公司地址）#R#座机电话（各地配送中心电话或青岛公司电话，格式如0535-80913556）#R#邮箱#R#名片寄送地址（建议填各地配送中心）#R#个人手机
HLdYtoSveyrM	姓名#R#性别#R#出生地#R#籍贯#R#身份证号#R#民族#R#政治面貌#R#户口所在地#R#班内学号#R#班级#R#入学年月#R#入学方式#R#就读方式#R#家庭住址#R#QQ号码#R#家庭成员或监护人信息：姓名#R#关系#R#民族#R#工作单位#R#现住址#R#户口所在地#R#家庭成员或监护人的联系电话（手机）#R#是否为监护人#R#联系电话（手机）#R#QQ号码#R#家庭成员或监护人信息：姓名#R#关系
eFSkuluVZSMw	姓名#R#性别#R#出生地#R#籍贯#R#身份证号#R#民族#R#政治面貌#R#户口所在地#R#班内学号#R#班级#R#入学年月#R#入学方式#R#就读方式#R#家庭住址#R#QQ号码#R#家庭成员或监护人信息：姓名#R#关系#R#民族#R#工作单位#R#现住址#R#户口所在地#R#家庭成员或监护人的联系电话（手机）#R#是否为监护人#R#联系电话（手机）#R#QQ号码#R#家庭成员或监护人信息：姓名#R#关系
JGoOpIJnrWRF	您使用过店大侠吗？
GyHddtLrJnrr	姓名#R#性别#R#出生地#R#籍贯#R#身份证号#R#民族#R#政治面貌#R#户口所在地#R#班内学号#R#班级#R#入学年月#R#入学方式#R#就读方式#R#家庭住址#R#QQ号码#R#家庭成员或监护人信息：姓名#R#关系#R#民族#R#工作单位#R#现住址#R#户口所在地#R#家庭成员或监护人的联系电话（手机）#R#是否为监护人#R#联系电话（手机）#R#QQ号码#R#家庭成员或监护人信息：姓名#R#关系
BDIxYlySzfkI	姓名#R#性别
QZXTaQRiKhja	你的姓名#R#你的手机号码#R#家庭住址#R#离校时间#R#乘坐回家的方式#R#回家过程是否有停留#R#估计到家时间
KHGFCUamStSr	姓名#R#性别#R#出生地#R#籍贯#R#身份证号#R#民族#R#政治面貌#R#户口所在地#R#班内学号#R#班级#R#入学年月#R#入学方式#R#就读方式#R#家庭住址#R#QQ号码#R#家庭成员或监护人信息：姓名#R#关系#R#民族#R#工作单位#R#现住址#R#户口所在地#R#家庭成员或监护人的联系电话（手机）#R#是否为监护人#R#联系电话（手机）#R#QQ号码#R#家庭成员或监护人信息：姓名#R#关系
APUpGOdZaTSl	你的姓名#R#职务#R#参与社团活动次数#R#活动名称（截至到12月15日，包括社团名、几月几日）有几个填几个
JRHkVGkmAdqE	你的性别#R#您来自哪里#R#您多久观看一场荆州花鼓戏
TUxQtTzactNt	test
cEzBQQRCGTYs	姓名#R#性别#R#出生地#R#籍贯#R#身份证号#R#民族#R#政治面貌#R#户口所在地#R#班内学号#R#班级#R#入学年月#R#入学方式#R#就读方式#R#家庭住址#R#QQ号码#R#家庭成员或监护人信息：姓名#R#关系#R#民族#R#工作单位#R#现住址#R#户口所在地#R#家庭成员或监护人的联系电话（手机）#R#是否为监护人#R#联系电话（手机）#R#QQ号码#R#家庭成员或监护人信息：姓名#R#关系
eTXrLEgzWRlr	你的姓名#R#你的手机号码#R#支付宝账号#R#支付宝姓名#R#你的身份证号码
YaekYumPgKHV	工作单位#R#姓名#R#性别#R#手机#R#QQ号#R#微信号#R#是否住校#R#出生日期#R#家长姓名#R#家长电话（手机）#R#家庭住址
dfuaKXenQNlv	姓名#R#杨鸿明#R#性别男#R#手机#R#QQ号：1853632677#R#微信号#R#是否住校：是#R#出生日期#R#家长姓名#R#家长电话（手机）#R#家庭住址
dLbsHMfcnkjx	姓名#R#性别#R#手机#R#QQ号#R#微信号#R#是否住校#R#出生日期#R#家长姓名#R#家长电话（手机）#R#家庭住址
GlWQSCDyfPyg	姓名#R#性别#R#出生日期#R#学院#R#手机号码#R#QQ#R#为什么会考虑加入XX社#R#觉得自己加入XX社的优势#R#对于XX社的看法和建议#R#QQ#R#自我评价#R#意愿部门
VoPccpzosiFe	昵称#R#企鹅号#R#任务完成情况#R#下阶段完成事务#R#报告时间#R#QQ#R#为什么会考虑加入XX社#R#觉得自己加入XX社的优势#R#对于XX社的看法和建议#R#QQ#R#自我评价#R#意愿部门
TPdyIYNWdHTA	您的免单产品是#R#订单号
KJGRCNFTpeny	姓名#R#性别#R#出生地#R#籍贯#R#身份证号#R#民族#R#政治面貌#R#户口所在地#R#班内学号#R#班级#R#入学年月#R#入学方式#R#就读方式#R#家庭住址#R#QQ号码#R#家庭成员或监护人信息：姓名#R#关系#R#民族#R#工作单位#R#现住址#R#户口所在地#R#家庭成员或监护人的联系电话（手机）#R#是否为监护人#R#联系电话（手机）#R#QQ号码#R#家庭成员或监护人信息：姓名#R#关系
dqLPuDpNIdWK	项目名称#R#申请时间#R#指导教师#R#经费来源
JzmpWiQLtuZD	姓名#R#性别#R#手机#R#QQ号#R#微信号#R#是否住校#R#出生日期#R#家长姓名#R#家长电话（手机）#R#家庭住址
SfOjbbdeUysw	学号
efySCyWLVjVT	专业
eYwLkmMJOdGp	加盟客户姓名#R#第一审核人#R#签字人手机号#R#签字人姓名#R#加盟商性质#R#地址#R#社会信用代码#R#营业执照编号#R#签字人身份证号
epDIBECkKJki	姓名#R#性别#R#出生地#R#籍贯#R#身份证号#R#民族#R#政治面貌#R#户口所在地#R#班内学号#R#班级#R#入学年月#R#入学方式#R#就读方式#R#家庭住址#R#QQ号码#R#家庭成员或监护人信息：姓名#R#关系#R#民族#R#工作单位#R#现住址#R#户口所在地#R#家庭成员或监护人的联系电话（手机）#R#是否为监护人#R#联系电话（手机）#R#QQ号码#R#家庭成员或监护人信息：姓名#R#关系
BRFkVjCrLxQs	姓名杨显朋#R#性别#R#手机18598272272#R#QQ号2353663555#R#微信号gz79797#R#是否住校#R#出生日期#R#家长姓名#R#家长电话（手机）#R#家庭住址
FfMJGShuQPKF	姓名#R#性别#R#手机#R#QQ号#R#微信号#R#是否住校#R#出生日期#R#家长姓名#R#家长电话（手机）#R#家庭住址
YEsUvASsQrlc	你的手机号码#R#你的姓名#R#你的取件码
PBAyyLWRVoZf	姓名#R#性别#R#手机#R#所属班组#R#QQ号#R#微信号#R#是否住校#R#出生日期#R#家长姓名#R#家长电话（手机）#R#家庭住址
PmyGyDcbjRMr	姓名#R#性别#R#出生地#R#籍贯#R#身份证号#R#民族#R#政治面貌#R#户口所在地#R#班内学号#R#班级#R#入学年月#R#入学方式#R#就读方式#R#家庭住址#R#QQ号码#R#家庭成员或监护人信息：姓名#R#关系#R#民族#R#工作单位#R#现住址#R#户口所在地#R#家庭成员或监护人的联系电话（手机）#R#是否为监护人#R#联系电话（手机）#R#QQ号码#R#家庭成员或监护人信息：姓名#R#关系
PalLiNqGMRmt	姓名#R#性别#R#出生地#R#籍贯#R#身份证号#R#民族#R#政治面貌#R#户口所在地#R#班内学号#R#班级#R#入学年月#R#入学方式#R#就读方式#R#家庭住址#R#QQ号码#R#家庭成员或监护人信息：姓名#R#关系#R#民族#R#工作单位#R#现住址#R#户口所在地#R#家庭成员或监护人的联系电话（手机）#R#是否为监护人#R#联系电话（手机）#R#QQ号码#R#家庭成员或监护人信息：姓名#R#关系
MAPkiiVzuKjh	姓名#R#性别#R#出生日期#R#学院#R#手机号码#R#QQ#R#为什么会考虑加入XX社#R#觉得自己加入XX社的优势#R#对于XX社的看法和建议#R#QQ#R#自我评价#R#意愿部门
ZdSvSpmINgGH	你的学号+姓名#R#根据第二周的学习目标“把‘我不行’的自动化思维更新为‘我试试’”，制定你自己的行动力小目标#R#除了你自己的小目标外，你还愿意在哪些训练营学习上做突破和尝试？#R#一天当中你的相对空闲时间段（方便班班找你私聊哟）#R#00-8#R#00#R#00-9#R#00#R#00-13#R#00#R#00-14#R#00#R#00-19#R#00#R#00-22#R#00#R#00-24#R#00#R#00-1#R#00#R#请写下你对下一周航行的期待
VOcllHJoUiqK	学生姓名#R#性别#R#出生地#R#籍贯#R#身份证号#R#民族#R#政治面貌#R#户口所在地#R#班内学号#R#班级#R#入学年月#R#入学方式#R#就读方式#R#现家庭住址#R#QQ号码#R#接学生人员关系#R#关系#R#民族#R#工作单位#R#现住址#R#户口所在地#R#家庭成员或监护人的联系电话（手机）#R#是否为监护人#R#接学生人员联系电话（手机）#R#QQ号码#R#家庭成员或监护人信息：姓名#R#关系
bHHQKwRHiRff	姓名#R#性别#R#出生日期#R#学院#R#手机号码#R#QQ#R#为什么会考虑加入XX社#R#觉得自己加入XX社的优势#R#对于XX社的看法和建议#R#QQ#R#自我评价#R#意愿部门
RzJWZIMtSCfr	您的群资源类型#R#你想要的群资源类型#R#交换群人数#R#岗位职级#R#您的微信号
RtGHfTgEJICQ	姓名#R#不能参加的原因？#R#部门#R#手机号码#R#邮箱#R#课程选择#R#岗位#R#方便参加课程时间#R#近期意向学习内容#R#是否参加12月17日党员会议？#R#20-20#R#20,13号会议室)
NSCFHEXNNYYO	你的姓名#R#专业（全称）#R#学号#R#性别#R#籍贯#R#手机#R#学号#R#专业#R#学号#R#姓名#R#你的手机号码#R#你的性别#R#你的专业#R#你的学号#R#你的籍贯
MgCWexcrAGjy	主题清晰度（100分满分）#R#声音洪亮度（100分满分）#R#表达自信度（100分满分）#R#演讲形象（100满分）（站姿、眼神）#R#互动性（100分满分）（眼神互动、邀请听众回答）#R#演讲的吸引力（100分满分）
JSXviWEYfWGl	你的姓名
ODZsXfZDCJqW	最佳节目
KwZFIIUlInFy	孩子姓名#R#是否安全到家#R#未命名的标题
aUyiXQWeRTRr	你的姓名
BcVvAQLQjagz	姓名#R#性别#R#出生地#R#籍贯#R#身份证号#R#民族#R#政治面貌#R#户口所在地#R#班内学号#R#班级#R#入学年月#R#入学方式#R#就读方式#R#家庭住址#R#QQ号码#R#家庭成员或监护人信息：姓名#R#关系#R#民族#R#工作单位#R#现住址#R#户口所在地#R#家庭成员或监护人的联系电话（手机）#R#是否为监护人#R#联系电话（手机）#R#QQ号码#R#家庭成员或监护人信息：姓名#R#关系
PxdxowmNsgsN	测试
FqcomaEXgyYl	姓名#R#手机号码#R#你的邮箱#R#QQ号#R#提交日期
fzowRpMkTRKt	你的性别#R#你的性别
euqlQCvFXNRR	姓名#R#性别#R#出生日期#R#学院#R#手机号码#R#QQ#R#为什么会考虑加入XX社#R#觉得自己加入XX社的优势#R#对于XX社的看法和建议#R#QQ#R#自我评价#R#意愿部门
JDRqGykOEykz	PPT
eyKMRRxmPUkK	11#R#44545#R#22#R#33#R#44
EMMDGANbSyHO	姓名#R#部门#R#手机号码#R#邮箱#R#课程选择#R#岗位#R#方便参加课程时间#R#近期意向学习内容#R#其他建议
DsmZDkxSsmOJ	你的姓名#R#你的手机号码#R#您需要几张入场券
WlClhmZJabpt	您的姓名#R#公司/团队名称#R#岗位职级#R#岗位职级#R#联系电话（手机）
AqEtetYcJUKG	你的姓名#R#预估分数#R#当前存在的问题#R#解决问题的措施#R#薄弱学科一#R#薄弱学科一存在问题的版块#R#薄弱学科二存在问题的版块#R#解决薄弱学科一的措施#R#解决薄弱学科二的措施#R#薄弱学科二#R#你想说的其他的话#R#未命名的标题
DormbVbtCxFI	姓名：#R#【填空】重大网络割接的窗口时间是几点至几点？#R#【填空】请写出南充联通两个统一值班电话号码？#R#请写出南充联通两个统一值班电话号码？#R#【填空】平安保险理赔电话号码是多少？#R#平安保险理赔电话号码是多少？#R#据代维协议传输网核心层网元之间光缆故障要求在（）小时内完成抢代通；地市传输网汇聚层网元之间光缆故障要求在（）小时内完成抢代通；已造成集团客户业务中断的本地网光缆故障一般要求在（）小时内完成抢代通。#R#填空】业务故障时，应遵循 先（ ）后（ ）；先 ( )后（ ）；先 本端 ，后对端；先网内，后网外，分故障等级进行处理”的总原则进行故障处理。#R#【多选】现场照片拍照要尽量反映（）#R#【多选】光缆线路维护人员应熟悉光缆线路的 ( )，发现危及线路设施安全的情况#R#【多选】以下哪些属于管道光缆线路的主要维护工作（ ）。#R#【单选】整流模块时应按以下 ( ) 方式开启。#R#【单选】基站开关电源二次下电电压设置比电池保护电压设置要 ( ）#R#【单选】当障碍发生后，维护人员遵循( )的原则进行抢修#R#【单选】障碍发生后，应最大限度地减少线路中断损失和线路中断历时。调度前首先和( )联系，了解电路受影响情况。#R#【单选】综合代维技术规范中，在车巡中，光缆（维护）代维单位对可能危及光缆安全的场镇、跨越公路、村庄、易垮塌的地段每周至少巡查（）次，一般线路按作业计划。高速公路中线路巡回周期为（）次/月；#R#【单选】光缆以牵引方式敷设时，主要牵引力应加在光缆的 ( )上。#R#【单选】综合代维技术规范要求线路抢险人员在在收到故障派单后，应在（ ）分钟内出发，市区（）小时之内、郊区（ ）小时之内赶到现场。#R#【单选】下列关于代维光缆线路障碍抢修流程的表述，不正确的为( ) 。#R# 【填空】光纤通信是以（ ）为信息载体，以光纤为（ ）的通信方式。#R# 【填空】光纤光缆施工的技术指标要求在1550nm波长上，衰减值应≤（ ）dB/km。#R# 【填空】光缆敷设的一般规定光缆的弯曲半径应不小于光缆外径的（ ）倍，施工过程中应不小于（ ）倍。#R# 【填空】光纤熔接时应同续号的纤芯相接,并将每一接续盒的资料在竣工文件中记录，OTDR双向测试，接点衰耗不大于（ ）dB。#R# 【填空】光缆挂钩的卡挂间距为（ ）CM，允许偏差应不大于±3CM。挂钩在吊线上的搭扣方向应一致，挂钩托板齐全。#R# 【填空】角深大于5米的角杆，吊线坡度变更超过杆距的5％小于10％，吊线应做（ ）装置。#R# 【填空】光缆跨越公路（含机根道）与路间净距不小于（ ）米，跨越土路（没有车辆可通行的路）时缆路间净距不小于（ ）米。#R# 【简答】简要说明为什么要执行巡检制度，如何执行？#R# 【简答】架空线路的主要维护工作有哪些？
bGnABXoGlrVs	姓 名#R#中文姓拼音#R#中文名拼音#R#认证方向#R#学校#R#手机号#R#邮 箱#R#身份证号#R#华为账号#R#华为账号密码#R#考试代码#R#班级
AkOGJWUfMBNP	姓名#R#性别#R#出生日期#R#学院#R#手机号码#R#QQ#R#为什么会考虑加入XX社#R#觉得自己加入XX社的优势#R#对于XX社的看法和建议#R#QQ#R#自我评价#R#意愿部门
cysNODtKelBi	你的网址#R#你的网址#R#你的邮箱#R#你的身份证号码#R#请问怎么能查到解码的方法呢？
IOuCbINdGBUz	你的服装尺寸#R#你的服装尺寸
QGtIlAnDvNnI	姓名#R#性别#R#出生地#R#籍贯#R#身份证号#R#民族#R#政治面貌#R#户口所在地#R#班内学号#R#班级#R#入学年月#R#入学方式#R#就读方式#R#家庭住址#R#QQ号码#R#家庭成员或监护人信息：姓名#R#关系#R#民族#R#工作单位#R#现住址#R#户口所在地#R#家庭成员或监护人的联系电话（手机）#R#是否为监护人#R#联系电话（手机）#R#QQ号码#R#家庭成员或监护人信息：姓名#R#关系
PVpqQNWiLSJM	您在课后习题中遇到的问题怎么解决?#R#你的姓名#R#你的性别#R#你的学号#R#您平时上课的表现是什么#R#您的课后复习情况怎么样？#R#您在课后习题中遇到的有关专业知识问题怎么解决?#R#您参加的课外活动有哪些?它给你带来了什么?#R#课后您一般在哪里完成课后作业?#R#您对您课后的安排有什么想法？#R#您会用多少时间待在书屋或者图书馆#R#您在课后习题中遇到的问题怎么解决?
eFBtmpqiPbaA	姓名#R#性别#R#手机#R#QQ号#R#微信号#R#是否住校#R#出生日期#R#家长姓名#R#家长电话（手机）#R#家庭住址
XHLhLLHdDWlF	姓名#R#性别#R#出生地#R#籍贯#R#身份证号#R#民族#R#政治面貌#R#户口所在地#R#班内学号#R#班级#R#入学年月#R#入学方式#R#就读方式#R#家庭住址#R#QQ号码#R#家庭成员或监护人信息：姓名#R#关系#R#民族#R#工作单位#R#现住址#R#户口所在地#R#家庭成员或监护人的联系电话（手机）#R#是否为监护人#R#联系电话（手机）#R#QQ号码#R#家庭成员或监护人信息：姓名#R#关系
WMDRRNDHfzix	姓名#R#性别#R#手机#R#QQ号#R#微信号#R#是否住校#R#出生日期#R#家长姓名#R#家长电话（手机）#R#家庭住址
MlDDNzakAXTe	主题清晰度（100分满分）#R#声音洪亮度（100分满分）#R#表达自信度（100分满分）#R#演讲形象（100满分）（站姿、眼神）#R#互动性（100分满分）（眼神互动、邀请听众回答）#R#演讲的吸引力（100分满分）
IvQAyBMBvHDW	你的姓名#R#你的性别#R#联系方式#R#对于社团的看法以及你建议社团该怎样发展
VjacAbuzfkzw	你的姓名
aleZLtiATIsg	姓名#R#性别#R#出生地#R#籍贯#R#身份证号#R#民族#R#政治面貌#R#户口所在地#R#班内学号#R#班级#R#入学年月#R#入学方式#R#就读方式#R#家庭住址#R#QQ号码#R#家庭成员或监护人信息：姓名#R#关系#R#民族#R#工作单位#R#现住址#R#户口所在地#R#家庭成员或监护人的联系电话（手机）#R#是否为监护人#R#联系电话（手机）#R#QQ号码#R#家庭成员或监护人信息：姓名#R#关系
UzKyBmTTLkhb	你的身份证号码#R#在干什么呢?#R#还在不?
OMFEBZfyaidW	串串牛肉15元一把、（30串）#R#在这项输入联系方式和地址哦
dVNdgmYEjLoo	问题标题19.7553644839
BagVgootAwwi	姓名#R#性别#R#手机#R#QQ号#R#微信号#R#哪家运营商#R#身份证号码#R#装机地址#R#宽带套餐#R#家长电话（手机）#R#家庭住址
VfgMObuXenFl	姓名#R#性别#R#院系和年级#R#手机号码#R#简单自我介绍#R#QQ号码#R#民族#R#政治面貌#R#户口所在地#R#班内学号#R#班级#R#入学年月#R#入学方式#R#就读方式#R#家庭住址#R#QQ号码#R#家庭成员或监护人信息：姓名#R#关系#R#民族#R#工作单位#R#现住址#R#户口所在地#R#家庭成员或监护人的联系电话（手机）#R#是否为监护人#R#联系电话（手机）#R#QQ号码#R#家庭成员或监护人信息：姓名#R#关系
bSkMnMGaIoNN	你的姓名#R#你的手机号码#R#你的身份证号码#R#你的邮箱
fAAIRnWmYrzB	姓名（真实姓名）#R#性别#R#年龄#R#个人才艺（请输入你的特长）#R#直播时间段（例如：19点-22点）#R#手机号码#R#QQ#R#能否稳定直播25个有效天60小时#R#对接经纪人昵称（没有经纪人填写无）#R#对接经纪人QQ（没有经纪人填写无）#R#才艺展示视频链接（抖音或者腾讯视频链接均可）#R#觉得自己加入XX社的优势#R#对于XX社的看法和建议#R#QQ#R#自我评价#R#意愿部门
cXituYLAqwoH	你的姓名#R#你的身份证号码
TyRomaiBhqQa	时间#R#姓名#R#所属区#R#多选#R#当日具体地点，树木品种及数量
AHhwfWLFShsh	姓名#R#部门#R#手机号码#R#邮箱#R#课程选择#R#岗位#R#方便参加课程时间#R#近期意向学习内容#R#其他建议
YjngUJyZHHzf	姓名#R#性别#R#手机#R#QQ号#R#微信号#R#是否住校#R#出生日期#R#家长姓名#R#家长电话（手机）#R#家庭住址
SxygyQpBgxun	日期#R#具体工作人员姓名#R#村、社区名称#R#报刊亭、书店地址#R#报刊亭、书店名称#R#规模、大小#R#店负责人#R#负责人电话号码#R#工商营业执照、出版物经营许可证、税务登记办证情况跟进状态#R#是否有计划建设书店#R#未发展建设实体书店原因
VMCwculvFclz	你的姓名
SigZKdhQVjQR	姓名#R#班级号，例如PB02006#R#手机号#R#邮箱#R#是否已经加入浙江校友会微信群#R#交费方式
HPBKAaJfOOgU	姓名#R#性别#R#出生日期#R#学院#R#手机号码#R#QQ#R#为什么会考虑加入XX社#R#觉得自己加入XX社的优势#R#对于XX社的看法和建议#R#QQ#R#自我评价#R#意愿部门
ZrVSxZLpkYyM	您孩子的姓名#R#参加人员#R#下午是否留园#R#你的手机号码
QYIpvKewSyjp	姓名#R#性别#R#出生地#R#籍贯#R#身份证号#R#民族#R#政治面貌#R#户口所在地#R#班内学号#R#班级#R#入学年月#R#入学方式#R#就读方式#R#家庭住址#R#QQ号码#R#家庭成员或监护人信息：姓名#R#关系#R#民族#R#工作单位#R#现住址#R#户口所在地#R#家庭成员或监护人的联系电话（手机）#R#是否为监护人#R#联系电话（手机）#R#QQ号码#R#家庭成员或监护人信息：姓名#R#关系
WRsbDLRoOTKm	你的姓名#R#最后一门考试时间#R#倒数第二门考试时间#R#预计回家时间
OhEYSMEyrRVf	姓名#R#性别#R#手机#R#QQ号#R#微信号#R#是否住校#R#出生日期#R#家长姓名#R#家长电话（手机）#R#家庭住址
p5c150c1a234874af94043845014a35ae	你的姓名#R#你的手机号码#R#放假日期
PZllisrHonlC	你的姓名#R#你的手机号码#R#你的身份证号码#R#你的邮箱#R#你的性别#R#你的出生年月
NSziABvDoBDy	姓名#R#性别#R#出生日期#R#班级#R#手机号码#R#QQ#R#为什么会考虑加入摄影社#R#觉得自己加摄影X社的优势#R#对于摄影社的看法和建议#R#QQ#R#自我评价#R#意愿部门
MmIotDyhKvCI	姓名#R#性别#R#出生地#R#籍贯#R#身份证号#R#民族#R#政治面貌#R#户口所在地#R#班内学号#R#班级#R#入学年月#R#入学方式#R#就读方式#R#家庭住址#R#QQ号码#R#家庭成员或监护人信息：姓名#R#关系#R#民族#R#工作单位#R#现住址#R#户口所在地#R#家庭成员或监护人的联系电话（手机）#R#是否为监护人#R#联系电话（手机）#R#QQ号码#R#家庭成员或监护人信息：姓名#R#关系
SAdnSQvFpUgi	姓名#R#性别#R#出生地#R#籍贯#R#身份证号#R#民族#R#政治面貌#R#户口所在地#R#班内学号#R#班级#R#入学年月#R#入学方式#R#就读方式#R#家庭住址#R#QQ号码#R#家庭成员或监护人信息：姓名#R#关系#R#民族#R#工作单位#R#现住址#R#户口所在地#R#家庭成员或监护人的联系电话（手机）#R#是否为监护人#R#联系电话（手机）#R#QQ号码#R#家庭成员或监护人信息：姓名#R#关系
JojoiISlwduz	马季颖
OmGTlqzXHnQf	您的姓名#R#公司/团队名称#R#岗位职级#R#岗位职级#R#联系电话（手机）
QqlJTEwCmRmx	微信名#R#性别#R#出生日期#R#为什么报名运营官？#R#手机号码#R#QQ#R#为什么会考虑加入XX社#R#觉得自己加入XX社的优势#R#对于XX社的看法和建议#R#QQ#R#自我评价#R#意愿部门
aIseOLfFBqCH	您的姓名#R#公司/团队名称#R#岗位职级#R#岗位职级#R#联系电话（手机）
LHDXNxCdRWNC	姓名#R#性别#R#手机#R#QQ号#R#微信号#R#是否住校#R#出生日期#R#家长姓名#R#家长电话（手机）#R#家庭住址
p5c1647d3041e74af9404558f023cb46a	你的姓名#R#生源地#R#贷款金额
eNRTXcNkITqX	姓名#R#性别#R#出生地#R#籍贯#R#身份证号#R#民族#R#政治面貌#R#户口所在地#R#班内学号#R#班级#R#入学年月#R#入学方式#R#就读方式#R#家庭住址#R#QQ号码#R#家庭成员或监护人信息：姓名#R#关系#R#民族#R#工作单位#R#现住址#R#户口所在地#R#家庭成员或监护人的联系电话（手机）#R#是否为监护人#R#联系电话（手机）#R#QQ号码#R#家庭成员或监护人信息：姓名#R#关系
DqDRFXuHqdJF	你的姓名
CXPGIYMLxnzl	你的姓名#R#What do you think is happiness？
HDgytUeLKuZH	幼儿姓名#R#幼儿尺码#R#家长#R#家长尺码
TyAFHJDbHsvr	你的姓名#R#日期#R#订单号#R#订单号
XMqKJmRdCfME	衣服#R#进价#R#卖价#R#哪天卖的
UeOOjfMwDnmX	日期#R#收据号#R#工程名称#R#收款是由#R#金额#R#经办人
YJdrasgrWukW	你的姓名
ObWvjGwzOmnk	出生年月
aOsHWbxSisKq	您的姓名#R#公司/团队名称#R#岗位职级#R#岗位职级#R#联系电话（手机）
RZueTzgnFhqk	姓名#R#性别#R#出生日期#R#学院#R#手机号码#R#QQ#R#为什么会考虑加入XX社#R#觉得自己加入XX社的优势#R#对于XX社的看法和建议#R#QQ#R#自我评价#R#意愿部门
bzorSKAPsFwn	姓名#R#性别#R#出生日期#R#学院#R#手机号码#R#QQ#R#为什么会考虑加入XX社#R#觉得自己加入XX社的优势#R#对于XX社的看法和建议#R#QQ#R#自我评价#R#意愿部门
HqaFknjFsEBP	你的姓名
eojkKAunlwYo	你的姓名#R#你的手机号码#R#你的性别
KlacSugKWXrw	你的姓名#R#你的手机号码#R#你的身份证号码#R#你的性别#R#123
RXmiAGgIvxrs	您的Q号#R#希望安利的坑的名字#R#漫画最后更新时间#R#备注#R#原作连载中还是已经完结？
eAdmHHWoSFEm	订单序号#R#订单日期#R#免单品类#R#订单编号#R#提交人#R#订单金额
babAiyDqCYtr	姓名 #R#主要负责片区#R#接通客户来电后 客户要确认您身份通常如何发问 （至少罗列三例）#R#客户如何表述订购需求 想要什么 （至少罗列五例）#R#客户如何询问价格 折扣 （至少罗列五例）#R#客户如何询问货期 （至少罗列三例）#R#客户如何询问递送方式#R#关于赠品 小礼物 客户怎么问过 （罗列三例以上 多多益善）#R#关于产品品质 客户提过哪些问题 （罗列三例以上 多多益善）#R#关于货比三家 客户曾如何表述 （列举三例以上）#R#关于下单方式 客户曾如何询问 （列举三例以上）#R#关于账期 发票 付款方式客户问过哪些问题 （列举三例以上）#R#关于售后服务客户提过哪些诉求 （列举三例以上）#R#关于使用方法 客户曾如何发问 （列举三例以上）#R#关于公司实力 资质 客户问过哪些问题#R#技术服务意向客户提过哪些问题 （列举三例以上）#R#订错货客户曾如何表达诉求 #R#关于管控试剂客户问过哪些产品 #R#投诉环节客户如何描述产品问题 （列举五例以上）#R#补充 其他在客户沟通中遇到的有价值的问题罗列一下
JsubYXcBVAjw	你的姓名
JxyqgQesyOLl	姓名#R#机构-区域（例如：昆明二区）#R#手机号码#R#性别#R#课程选择#R#饮食需求#R#是否参加过新人班#R#是否有同业经历#R#是否有其他需求#R#是否能全程参与新人班
JQxMokOGCZri	你的服装尺寸#R#你的姓名#R#你的服装尺寸
TVEWmYrmaIOo	您的姓名#R#公司/团队名称#R#岗位职级#R#岗位职级#R#联系电话（手机）
IKaeYDQqRsnY	自然名#R#姓名#R#性别#R#身份证号#R#手机号#R#未命名的标题
EnvFhkAdJTXW	你的姓名
RvRtiWpkVuaX	你的小孩姓名
XRwYXOJuuXUZ	姓名#R#性别#R#出生地#R#籍贯#R#身份证号#R#民族#R#政治面貌#R#户口所在地#R#班内学号#R#班级#R#入学年月#R#入学方式#R#就读方式#R#家庭住址#R#QQ号码#R#家庭成员或监护人信息：姓名#R#关系#R#民族#R#工作单位#R#现住址#R#户口所在地#R#家庭成员或监护人的联系电话（手机）#R#是否为监护人#R#联系电话（手机）#R#QQ号码#R#家庭成员或监护人信息：姓名#R#关系
MmYJbumxguJZ	姓名#R#学号#R#团员评价材料的题目
MAmPSjoojRHu	姓名#R#性别#R#手机#R#QQ号#R#微信号#R#是否住校#R#出生日期#R#家长姓名#R#家长电话（手机）#R#家庭住址
dOhfCWXQqONz	姓名#R#班级#R#性别#R#出生日期#R#学院#R#手机号码#R#QQ#R#为什么会考虑加入XX社#R#觉得自己加入XX社的优势#R#对于XX社的看法和建议#R#QQ#R#自我评价#R#意愿部门
DkIhOiVOXhmU	中文姓名（Chinese name）#R#性别#R#英文姓名（English name）#R#籍贯#R#身份证号#R#民族#R#政治面貌#R#户口所在地#R#班内学号#R#班级#R#入学年月#R#入学方式#R#就读方式#R#家庭住址#R#QQ号码#R#家庭成员或监护人信息：姓名#R#关系#R#民族#R#工作单位#R#现住址#R#户口所在地#R#家庭成员或监护人的联系电话（手机）#R#是否为监护人#R#联系电话（手机）#R#QQ号码#R#家庭成员或监护人信息：姓名#R#关系
EaHmuKZqSyNN	你的寝室号是#R#你的寝室需要报纸吗#R#你想要什么类型的报纸呢
NgFJSFaUmFeV	姓名#R#性别#R#手机#R#QQ号#R#微信号#R#是否住校#R#出生日期#R#家长姓名#R#家长电话（手机）#R#家庭住址
AyemOrWqVDva	你的性别#R#你的出生年月#R#你的学历
NrxAvEyPHKnv	家长姓名#R#电话
PCyCsqGEXoEX	姓名#R#性别#R#手机#R#QQ号#R#微信号#R#是否住校#R#出生日期#R#家长姓名#R#家长电话（手机）#R#家庭住址
FpCFFrcfbCjK	你的姓名
DkZWkHFFCisW	班级#R#楼层#R#登记人
FyabokSLpzIm	姓名#R#性别#R#出生地#R#籍贯#R#身份证号#R#民族#R#政治面貌#R#户口所在地#R#班内学号#R#班级#R#入学年月#R#入学方式#R#就读方式#R#家庭住址#R#QQ号码#R#家庭成员或监护人信息：姓名#R#关系#R#民族#R#工作单位#R#现住址#R#户口所在地#R#家庭成员或监护人的联系电话（手机）#R#是否为监护人#R#联系电话（手机）#R#QQ号码#R#家庭成员或监护人信息：姓名#R#关系
WMDRkmVwhFfY	日期#R#地点#R#活动主题#R#主要内容
YaLqjIdWpXxW	姓名#R#部门#R#手机号码#R#邮箱#R#课程选择#R#岗位#R#方便参加课程时间#R#近期意向学习内容#R#其他建议
QQAgHDhDoPef	姓名#R#性别#R#出生地#R#籍贯#R#身份证号#R#民族#R#政治面貌#R#户口所在地#R#班内学号#R#班级#R#入学年月#R#入学方式#R#就读方式#R#家庭住址#R#QQ号码#R#家庭成员或监护人信息：姓名#R#关系#R#民族#R#工作单位#R#现住址#R#户口所在地#R#家庭成员或监护人的联系电话（手机）#R#是否为监护人#R#联系电话（手机）#R#QQ号码#R#家庭成员或监护人信息：姓名#R#关系
EtrguKDPwcGu	周一上午3、4#R#周一下午7、8#R#周二上午3、4#R#周二下午7、8#R#周三上午3、4#R#周三下午7、8#R#周四上午3、4#R#周四下午7、8#R#周五上午3、4#R#周五下午7、8
NACgTYJtOzXg	家长姓名#R#电话号码
UGIftyBVXytV	你是否认为自己有为和谐社会做贡献的愿望#R#你的人生目标是怎样设计的#R#你的邮箱
DyPoMIJvsrtu	你的姓名#R#你的手机号码#R#你的邮箱#R#你的性别#R#你的出生年月
bsyNQXsdpcma	名称#R#QQ号
RgjsIYLkqHqe	服务日期#R#维护人员#R#维护情况#R#用户评价#R#维护建议#R#商家等级#R#反馈用户#R#KP联系电话#R#跟进状态#R#未签约原因
XijEQhvQkYvT	您的姓名#R#专业班级#R#公司/团队名称#R#岗位职级#R#岗位职级#R#联系电话（手机）
HvRWICfmHXLY	123123
PTPtJfyFSzIx	你的姓名#R#你的姓名#R#你的姓名
IWEASGojEJZr	你的姓名
HVNafICdIflD	你觉得你学习怎么样？#R#你觉得我在你心中的位置重要吗？#R#你觉得你了解我吗？#R#有没有在某些时候突然想起我？#R#你觉得我人品怎么样？#R#你觉得我了解你吗？#R#你觉得咱俩的友谊会长久下去吗？#R#你有喜欢的人吗？
MwxSQjwMMMih	主题清晰度（100分满分）#R#声音洪亮度（100分满分）#R#表达自信度（100分满分）#R#演讲形象（100满分）（站姿、眼神）#R#互动性（100分满分）（眼神互动、邀请听众回答）#R#演讲的吸引力（100分满分）
FPdIoOYpzkHX	姓名#R#性别#R#出生日期#R#学院#R#手机号码#R#QQ#R#为什么会考虑加入XX社#R#觉得自己加入XX社的优势#R#对于XX社的看法和建议#R#QQ#R#自我评价#R#意愿部门
HWXucuGbyuDL	日期#R#销售/BD姓名#R#拜访商家名称#R#商家地点#R#隶属公司#R#商家等级#R#KP（关键人）#R#KP联系电话#R#跟进状态#R#未签约原因
bKToLPyBDRwS	你的姓名#R#你的服装尺寸#R#身高#R#体重
UQuUqflNFgBK	姓名李继明#R#性别#R#出生地#R#籍贯#R#身份证号#R#民族#R#政治面貌#R#户口所在地#R#班内学号#R#班级#R#入学年月#R#入学方式#R#就读方式#R#家庭住址#R#QQ号码#R#家庭成员或监护人信息：姓名#R#关系#R#民族#R#工作单位#R#现住址#R#户口所在地#R#家庭成员或监护人的联系电话（手机）#R#是否为监护人#R#联系电话（手机）#R#QQ号码#R#家庭成员或监护人信息：姓名#R#关系
fbDrCTVTlmNs	日期#R#销售/BD姓名#R#拜访商家名称#R#商家地点#R#隶属公司#R#商家等级#R#KP（关键人）#R#KP联系电话#R#跟进状态#R#未签约原因
FApaWcMvKtzj	姓名#R#性别#R#出生日期#R#学院#R#手机号码#R#QQ#R#为什么会考虑加入XX社#R#觉得自己加入XX社的优势#R#对于XX社的看法和建议#R#QQ#R#自我评价#R#意愿部门
aRYvyDmfIhPy	稿件标题#R#操作原因#R#所在模块#R#稿件标题#R#操作类别#R#稿件来源#R#操作日期
XEnEtJtrjZqe	姓名#R#性别#R#出生地#R#籍贯#R#身份证号#R#民族#R#政治面貌#R#户口所在地#R#班内学号#R#班级#R#入学年月#R#入学方式#R#就读方式#R#家庭住址#R#QQ号码#R#家庭成员或监护人信息：姓名#R#关系#R#民族#R#工作单位#R#现住址#R#户口所在地#R#家庭成员或监护人的联系电话（手机）#R#是否为监护人#R#联系电话（手机）#R#QQ号码#R#家庭成员或监护人信息：姓名#R#关系
aJvebVGBgRXn	优点
UuCOvccfRGlD	姓名#R#加盟日期#R#推荐人#R#未命名的标题
FLWZwFWUIAdP	微信昵称#R#分享主题#R#分享时间
TxVNaFIjwSdO	姓名#R#性别#R#手机#R#QQ号#R#微信号#R#是否住校#R#出生日期#R#家长姓名#R#家长电话（手机）#R#家庭住址
InnHNZxouRGb	日期#R#销售/BD姓名#R#拜访商家名称#R#商家地点#R#隶属公司#R#商家等级#R#KP（关键人）#R#KP联系电话#R#跟进状态#R#未签约原因
TYxMiXDruiZj	你的姓名
YTmLUtpzrdol	教学组织管理：学校在教学管理制度建设、专业设置与管理、人才培养方案制定、课程与资源建设、实训基地建设等方面所做的工作及取得的成绩。（不超过2000字，附加支撑材料）#R#教学过程管理： 学校在课堂教学、实践教学等方面管理常规、改革创新及取得的成绩。（不超过1000字，附加支撑材料）#R#教学质量管理： 学校在质量保障机制、教学质量监控等方面所做的工作及取得的成绩。（不超过1000字，附加支撑材料）#R#教学团队管理： 学校在师资队伍建设、教师培养培训、教学管理队伍配置等方面所做的工作及取得的成绩。（不超过1500字，附加支撑材料）#R#教学管理信息化建设： 学校信息化教学管理平台建设情况及信息化教学管理水平。（不超过1000字，附加支撑材料）#R#教学管理成效与创新： 总结提炼学校教学管理工作的成效，包括育人质量、教学管理标志性成果等。（不超过1000字，附加支撑材料）#R#整体管理： 学校坚持立德树人、落实教学中心地位、校企协同育人、教学管理体制机制方面所做的工作。（不超过1000字，附加相应支撑材料）
MepGgHkYudaK	日期#R#项目#R#历年实收#R#历年减免#R#当年实收#R#当年减免#R#园区收入
AFlUMNKBDskT	姓名#R#性别#R#手机#R#QQ号#R#微信号#R#是否住校#R#出生日期#R#家长姓名#R#家长电话（手机）#R#家庭住址
emlMLOSqYvcL	你的姓名#R#你的手机号码#R#女#R#你的学历
KcMFCQnXntwY	姓名#R#性别#R#出生地#R#籍贯#R#身份证号#R#民族#R#政治面貌#R#户口所在地#R#班内学号#R#班级#R#入学年月#R#入学方式#R#就读方式#R#家庭住址#R#工衣码数#R#家庭成员或监护人信息：姓名#R#关系#R#民族#R#工作单位#R#现住址#R#户口所在地#R#家庭成员或监护人的联系电话（手机）#R#是否为监护人#R#联系电话（手机）#R#QQ号码#R#家庭成员或监护人信息：姓名#R#关系
IoskawFVfhHV	日期#R#销售/BD姓名#R#拜访商家名称#R#商家地点#R#隶属公司#R#商家等级#R#KP（关键人）#R#KP联系电话#R#跟进状态#R#未签约原因
POtjpcoXPhxw	学号+实名#R#到课情况
VVWucXAaKAaQ	你的姓名
MIqaFpGlAYyE	测试#R#日期
eAKqSWlEWsqg	专业
HurIpNpPQVWu	姓名#R#性别#R#手机#R#QQ号#R#微信号#R#是否住校#R#出生日期#R#家长姓名#R#家长电话（手机）#R#家庭住址
JEaVLmYrIUNm	姓名#R#性别#R#手机#R#QQ号#R#微信号#R#是否住校#R#出生日期#R#宿舍号 床位号#R#家长姓名#R#家长电话（手机）#R#家庭住址
NpmQXQcdjUWm	您的姓名#R#公司/团队名称#R#岗位职级#R#岗位职级#R#联系电话（手机）
MBLcXbwpuDDc	楼栋及房号#R#1号业主姓名#R#2号业主姓名#R#2号业主电话#R#1号业主性别#R#1号业主职业#R#1号业主电话#R#2号业主性别#R#你觉得业委会其他成员的每月劳动补贴多少适合？#R#3号业主姓名#R#3号业主电话#R#是否提供合同/不动产证复印件？#R#你觉得业委会主任的每月劳动补贴多少合适？#R#3号业主性别#R#你觉得业委会执行秘书的每月劳动补贴多少合适？#R#在即将召开的第一次业主大会，你及房屋共有人是否参与投票?#R#你推荐的参选业委会成员姓名及其住房门牌号？#R#你是否愿意成为业委会候补成员？#R#房屋专有建筑面积㎡#R#房屋建筑合计面积㎡#R#房屋公摊面积㎡#R#网络方式决议和投票？#R#电话方式决议和投票？#R#未命名的标题#R#楼栋及房号
OOFfgnIsvFFh	学生姓名#R#是否已交社保
PzECIkxMSCCY	旺旺：#R#订单号：#R#金额：
bRjhmHSSpiKp	姓名#R#学号#R#联系方式#R#书籍预订
GWFDkZKFDjAK	姓名#R#天天利2号的每天申购限额#R#新享理财当前的收益率是？
afRqsqnzLbOt	日期#R#销售/BD姓名#R#拜访商家名称#R#商家地点#R#隶属公司#R#商家等级#R#KP（关键人）#R#KP联系电话#R#跟进状态#R#未签约原因
AKbYEXuZJCBc	你的姓名#R#你的手机号码#R#你的身份证号码
amHiKoihKXPY	你的姓名
aPIWOvCyrXZG	学号#R#姓名#R#科目
RZZJkuWHedWL	想要的水果#R#瓜子花生#R#饮料
KAKrkzOiMpTQ	下單日期#R#客戶名稱#R#下單產品及數量#R#商家地点#R#客戶訂單號#R#商家等级#R#KP（关键人）#R#KP联系电话#R#跟进状态#R#未签约原因
DZPEfOjmhZjr	你所拍的免单#R#谁送给你免单#R#订单编号
VwZsVUaHSraE	你的姓名#R#你的手机号码
QOyjuhGbIznA	你的姓名#R#你的手机号码#R#你的身份证号码
RYJuAALeiwKQ	案例类型#R#你的姓名#R#来源#R#描述
BbyOCEroQygE	学生姓名#R#小饭桌名称
HwsWEQcvAXBi	你的姓名
WEkAZupeHPpY	项目#R#当年收缴率#R#历年收缴率
LYWcAnQdXsiI	你的身份证号码#R#你的姓名#R#你的手机号码#R#支付宝账号#R#工作日期#R#订单号汇总（订单号+金额）#R#推广数量#R#你的身份证号码
KotSgFgIbqAt	姓名#R#性别#R#出生地#R#籍贯#R#身份证号#R#民族#R#政治面貌#R#户口所在地#R#班内学号#R#班级#R#入学年月#R#入学方式#R#就读方式#R#家庭住址#R#QQ号码#R#家庭成员或监护人信息：姓名#R#关系#R#民族#R#工作单位#R#现住址#R#户口所在地#R#家庭成员或监护人的联系电话（手机）#R#是否为监护人#R#联系电话（手机）#R#QQ号码#R#家庭成员或监护人信息：姓名#R#关系
eViRRhwACDjs	姓名#R#性别#R#出生地#R#籍贯#R#身份证号#R#民族#R#政治面貌#R#户口所在地#R#班内学号#R#班级#R#入学年月#R#入学方式#R#就读方式#R#家庭住址#R#QQ号码#R#家庭成员或监护人信息：姓名#R#关系#R#民族#R#工作单位#R#现住址#R#户口所在地#R#家庭成员或监护人的联系电话（手机）#R#是否为监护人#R#联系电话（手机）#R#QQ号码#R#家庭成员或监护人信息：姓名#R#关系
dVSDSmcgyZzz	您的姓名#R#公司/团队名称#R#岗位职级#R#岗位职级#R#联系电话（手机）
RWfkbehuDyDR	你的姓名
bBCvkuLXLZiT	你的学历
UzqmTkKVSqfF	微信号#R#场次#R#日期位置#R#定金金额#R#票的数量#R#性别#R#手机#R#QQ号#R#微信号#R#是否住校#R#出生日期#R#家长姓名#R#家长电话（手机）#R#家庭住址
NuzoXoDOMqDA	姓名#R#店铺ID#R#店铺名称#R#手机号码#R#到场人数#R#职务#R#想问的问题
MGAtxCcwEgpp	姓名#R#性别#R#出生地#R#籍贯#R#身份证号#R#民族#R#政治面貌#R#户口所在地#R#班内学号#R#班级#R#入学年月#R#入学方式#R#就读方式#R#家庭住址#R#QQ号码#R#家庭成员或监护人信息：姓名#R#关系#R#民族#R#工作单位#R#现住址#R#户口所在地#R#家庭成员或监护人的联系电话（手机）#R#是否为监护人#R#联系电话（手机）#R#QQ号码#R#家庭成员或监护人信息：姓名#R#关系
DhyJFXwuaqbp	您所拍的免单是：#R#订单编号
MrKTGpSGwzKQ	是否住宿#R#性别#R#姓名#R#性别#R#备注#R#手机#R#QQ号#R#微信号#R#性别#R#是否吃晚餐#R#出生日期#R#家长姓名#R#家长电话（手机）#R#家庭住址
cPmhgwAYeSkh	店铺名称#R#订单编号#R#旺旺号#R#垫付金额#R#佣金#R#下单日期#R#下单时间#R#你的微信号#R#快递公司#R#物流编号
ZYyDwzqHyPCC	你的姓名曾莉#R#交流
NyrUPCsoDJuc	家长姓名#R#未命名的标题#R#电话
QKXvjUDKohPs	姓名#R#性别#R#手机#R#QQ号#R#微信号#R#是否住校#R#出生日期#R#家长姓名#R#家长电话（手机）#R#家庭住址
eweqfinrMWVk	name#R#phone#R#password#R#备注
ebrpjfZuuYhv	姓名#R#电话#R#是否参加
HFcmORgnGydS	姓名#R#性别#R#出生日期#R#学院#R#手机号码#R#QQ#R#为什么会考虑加入XX社#R#觉得自己加入XX社的优势#R#对于XX社的看法和建议#R#QQ#R#自我评价#R#意愿部门
adCgANwXqFLc	加框机#R#地面传输#R#提升机#R#提升机#R#药篮#R#软件优化
BQIIevPnlYDj	你的姓名#R#拟定休假时间
WADATDAFbYBL	你的姓名#R#你的手机号码#R#你的性别
bTIvOrWCTtMO	姓名#R#性别#R#出生地#R#籍贯#R#身份证号#R#民族#R#政治面貌#R#户口所在地#R#班内学号#R#班级#R#入学年月#R#入学方式#R#就读方式#R#家庭住址#R#QQ号码#R#家庭成员或监护人信息：姓名#R#关系#R#民族#R#工作单位#R#现住址#R#户口所在地#R#家庭成员或监护人的联系电话（手机）#R#是否为监护人#R#联系电话（手机）#R#QQ号码#R#家庭成员或监护人信息：姓名#R#关系
QnXXeNvyERzr	明日8点之前点餐10元，8点以后点餐15元
eIrIVdvalKSx	您孩子的姓名#R#参加运动会的人员#R#运动会结束后是否留园
ftcVavJYndid	姓名#R#性别#R#手机#R#QQ号#R#微信号#R#是否住校#R#出生日期#R#家长姓名#R#家长电话（手机）#R#家庭住址
JoWtKTQoiYvO	你的姓名
evaEuxLsOBMq	字母大小写对应
PHtrIpxoVJHz	姓名#R#性别#R#出生日期#R#学院#R#手机号码#R#QQ#R#为什么会考虑加入XX社#R#觉得自己加入XX社的优势#R#对于XX社的看法和建议#R#QQ#R#自我评价#R#意愿部门
OQpjVIUkwtDq	姓名#R#性别#R#手机#R#QQ号#R#微信号#R#是否住校#R#出生日期#R#家长姓名#R#家长电话（手机）#R#家庭住址
DYtBmbzPfJGO	姓名#R#团队的上级领导#R#手机号码#R#邮箱#R#课程选择#R#岗位#R#方便参加课程时间#R#近期意向学习内容#R#其他建议
HMjlgoFeNyeq	你的姓名#R#你的性别#R#你的出生年月#R#你的出生年月#R#你觉得你性格怎么样？
epxyGcYoUeaH	你的姓名#R#你的手机号码#R#你的身份证号码#R#支付宝账号#R#你的身份证号码
VyRnMKVBFaJG	姓名#R#性别#R#出生地#R#籍贯#R#身份证号#R#民族#R#政治面貌#R#户口所在地#R#班内学号#R#班级#R#入学年月#R#入学方式#R#就读方式#R#家庭住址#R#QQ号码#R#家庭成员或监护人信息：姓名#R#关系#R#民族#R#工作单位#R#现住址#R#户口所在地#R#家庭成员或监护人的联系电话（手机）#R#是否为监护人#R#联系电话（手机）#R#QQ号码#R#家庭成员或监护人信息：姓名#R#关系
IsqiQIFXjaRQ	所在门店(城市-店名)#R#路由器#R#客用宽带#R#运营商+宽带账号+密码+开户人+身份证（密码可不填，初次提交之后未变更可填“无变化”）)#R#财务宽带#R#运营商+宽带账号+密码+开户人+身份证（密码可不填，初次提交之后未变更可填“无变化”）)#R#客流#R#收银机#R#监控录像机#R#监控摄像头
HgElEtducDDN	你的手机号码#R#你的手机号码乃
eeFWtQEyHdrD	自动订货问卷#R#自动订货打分, 给几分. 满分5分. 不满意1分#R#哪些货物放不下#R#自动订货的货物哪些可以取消
ZIFQAwWzqGbp	姓名#R#性别#R#手机#R#QQ号#R#微信号#R#是否住校#R#出生日期#R#家长姓名#R#家长电话（手机）#R#家庭住址
WRIXSnhSvwuK	明天吃不吃#R#想对阿姨说的话/想吃的菜
KEhQOojBretC	您的姓名#R#公司/团队名称#R#岗位职级#R#岗位职级#R#联系电话（手机）
OPIXuYwyjYAr	你的姓名
TkDZzGPRFTyG	您的免单产品#R#订单号#R#免单负责人
HUfMOKMgOlAI	你的性别
fCgewdUcWxkH	姓名#R#部门#R#手机号码#R#邮箱#R#课程选择#R#岗位#R#方便参加课程时间#R#近期意向学习内容#R#其他建议
eNvSXMbOgIbg	姓名#R#参与1～23项，#R#24～47项，参加的有#R#岗位职级#R#联系电话（手机）
IYnBgvfPWHxq	姓名#R#部门#R#手机号码#R#邮箱#R#课程选择#R#岗位#R#方便参加课程时间#R#近期意向学习内容#R#其他建议
DlcMKfqeVaPp	你的姓名#R#你的姓名
VdksZkSSZqAO	实验人员姓名#R#实验名称#R#实验日期#R#是否出现问题，若有请详细说明
dtLpmnpTRpyj	网站名#R#网址
HJfZIxldIpgA	姓名#R#性别#R#出生日期#R#学院#R#手机号码#R#QQ#R#为什么会考虑加入XX社#R#觉得自己加入XX社的优势#R#对于XX社的看法和建议#R#QQ#R#自我评价#R#意愿部门
cAzXmiCFBkuY	姓名#R#性别#R#出生地#R#籍贯#R#身份证号#R#民族#R#政治面貌#R#户口所在地#R#班内学号#R#班级#R#入学年月#R#入学方式#R#就读方式#R#家庭住址#R#QQ号码#R#家庭成员或监护人信息：姓名#R#关系#R#民族#R#工作单位#R#现住址#R#户口所在地#R#家庭成员或监护人的联系电话（手机）#R#是否为监护人#R#联系电话（手机）#R#QQ号码#R#家庭成员或监护人信息：姓名#R#关系
HvJLPmGoicVj	你的姓名#R#你的姓名
TWMXxBbMilwj	请选择意向#R#常用联系方式#R#联系号码#R#邮箱#R#请选择要咨询的类别#R#请选择身份#R#方便参加课程时间#R#近期意向学习内容#R#请说明你的要求
TrFQTRfNhwut	你的姓名
UWpuLdKXnWnK	你的姓名#R#你的身份证号码#R#你的出生年月#R#你的手机号码#R#我承诺，我填写的信息均为真实，绝对不会盗取版权。#R#你的姓名#R#你的性别
QywBDSTBxkWt	姓名#R#出生年月#R#原学校#R#现学校#R#增加情况：调入或新招聘#R#调入或新招聘时间
DYrrbkOqgbXy	你的姓名#R#你的手机号码#R#你的性别#R#预计入住时间#R#预算#R#自身情况#R#对室友或者住宿条件的要求#R#其他想说的#R#预计入住时间
TnsUCDgqsKXz	您的免单产品是
KAICWaMycqYB	昵称#R#QQ#R#性别#R#出生年月日#R#自我介绍#R#对我社有什么看法#R#你认为成为我社社员（管理）最重要的是什么#R#实习开始时间#R#实习结束时间
PtulVzqYnEiS	你的姓名
TSpZsNItdLTM	是否参加活动
IVQYZLCuSJBE	姓名#R#性别#R#出生日期#R#学院#R#手机号码#R#QQ#R#为什么会考虑加入XX社#R#觉得自己加入XX社的优势#R#对于XX社的看法和建议#R#QQ#R#自我评价#R#意愿部门
DlWzutmKDRhn	姓名#R#地址（默认印公司地址，也可写各地配送中心）#R#座机电话（默认印公司电话，也可写当地配送中心）#R#手机#R#邮箱
fGgdbmYyauBY	姓名#R#性别#R#手机#R#QQ号#R#微信号#R#是否住校#R#出生日期#R#家长姓名#R#家长电话（手机）#R#家庭住址
WEDHAYTjICKl	你的服装尺寸
FqofzuGKqFCL	共青团
GRhbsqSZIejg	姓名#R#性别#R#出生地#R#籍贯#R#身份证号#R#民族#R#政治面貌#R#户口所在地#R#班内学号#R#班级#R#入学年月#R#入学方式#R#就读方式#R#家庭住址#R#QQ号码#R#家庭成员或监护人信息：姓名#R#关系#R#民族#R#工作单位#R#现住址#R#户口所在地#R#家庭成员或监护人的联系电话（手机）#R#是否为监护人#R#联系电话（手机）#R#QQ号码#R#家庭成员或监护人信息：姓名#R#关系
DwXujXWLSbQp	你的姓名
QSvMylLInCVv	你的姓名#R#子女姓名#R#性别#R#出生年月#R#子女姓名#R#子女性别#R#出生年月#R#备注说明
erNzLzQGPmEu	你的姓名#R#你的姓名
VpmOwopXRfak	QQ#R#手机号码#R#主页链接#R#视频链接#R#经纪人#R#经纪人QQ#R#微视昵称
AoYHpCTkesjy	你的手机号码#R#郑州市#R#
CbZGHktdrKSW	姓名#R#性别#R#手机#R#QQ号#R#微信号#R#是否住校#R#出生日期#R#家长姓名#R#家长电话（手机）#R#家庭住址
PgrpqWmUbwCX	姓名#R#性别#R#出生日期#R#学院#R#手机号码#R#QQ#R#为什么会考虑加入XX社#R#觉得自己加入XX社的优势#R#对于XX社的看法和建议#R#QQ#R#自我评价#R#意愿部门
PRxiTwvESBmA	你的姓名#R#你的性别#R#你的出生年月#R#你的学历#R#你的邮箱#R#你的手机号码#R#你的手机号码
DZmZClsGgGYB	姓名#R#性别#R#手机#R#QQ号#R#微信号#R#是否住校#R#出生日期#R#家长姓名#R#家长电话（手机）#R#现住址#R#身份号码#R#家庭住址
ANZgUKHVpAcv	你的姓名#R#语文#R#数学#R#英语#R#政治#R#历史#R#地理#R#总分
WIoAfwzyzlzJ	您的姓名#R#您的手机号码#R#您的收货地址#R#选择支付应用#R#请上传订单号#R#你的身份证号码
BKEppgAtZJYW	你的姓名
SEBZmXKADGOx	船家姓名：#R#联系电话：#R#所属城市和地区#R#出船区域#R#上船地点#R#主钓鱼种#R#最多乘坐人数#R#钓法#R#费用说明
JCJCebDYbHHm	Bug类型#R#Bug在哪个包下？#R#Bug在该包的哪个事件中？#R#填写有Bug的文本#R#您认为应该改成……
aMRXiXbDoLgo	姓名#R#性别#R#出生地#R#籍贯#R#身份证号#R#民族#R#政治面貌#R#户口所在地#R#班内学号#R#班级#R#入学年月#R#入学方式#R#就读方式#R#家庭住址#R#QQ号码#R#家庭成员或监护人信息：姓名#R#关系#R#民族#R#工作单位#R#现住址#R#户口所在地#R#家庭成员或监护人的联系电话（手机）#R#是否为监护人#R#联系电话（手机）#R#QQ号码#R#家庭成员或监护人信息：姓名#R#关系
ckiwSmDcZPMK	您的姓名#R#公司/团队名称#R#岗位职级#R#岗位职级#R#联系电话（手机）
WqcTrgqJNcAu	你的姓名#R#你的性别
AQxnmTiwpzrs	测试#R#姓名
TUIIaXSBmImL	您所拍的免单是#R#订单号#R#订单号#R#您所拍的免单是
chgGCTENbjJl	征文名#R#笔名
JPtBnDZtIrTj	你的姓名#R#你的手机号码#R#你的身份证号码#R#你的邮箱#R#你的出生年月#R#你喜欢吃哪些菜？
bvGHKkxzqsnl	22
baIENJysXFuZ	单位代码（3位数字）#R#单位名称#R#部门#R#联系人姓名#R#联系人ERP员工ID#R#联系人办公电话#R#联系人手机#R#联系人电子邮件
FbqkYeaLduoV	1.你对民间传统工艺有了解吗？了解多少？#R#2.你知道《我在故宫修文物》吗？
NbRsJNvjYTbf	学号#R#公司/团队名称#R#岗位职级#R#岗位职级#R#联系电话（手机）
EeMLCKpnWKEn	你的姓名#R#你的手机号码#R#需求数量
BfZbkmfCGeQc	你的姓名#R#你的手机号码#R#你的邮箱#R#你的性别#R#你的出生年月#R#从事工作及行业#R#特长技能
LJQHOVkLSyPw	姓名#R#性别#R#出生地#R#籍贯#R#身份证号#R#民族#R#政治面貌#R#户口所在地#R#班内学号#R#班级#R#入学年月#R#入学方式#R#就读方式#R#家庭住址#R#QQ号码#R#家庭成员或监护人信息：姓名#R#关系#R#民族#R#工作单位#R#现住址#R#户口所在地#R#家庭成员或监护人的联系电话（手机）#R#是否为监护人#R#联系电话（手机）#R#QQ号码#R#家庭成员或监护人信息：姓名#R#关系
bBAFUHAEuyOW	你的学历#R#你的服装尺寸#R#你的出生年月#R#你的性别
OLYEszanhDty	您的姓名#R#应聘职位#R#渠道来源#R#岗位职级#R#联系电话
SciVMHFhkxnB	姓名#R#性别#R#手机#R#QQ号#R#微信号#R#是否住校#R#出生日期#R#家长姓名#R#家长电话（手机）#R#家庭住址
fvpjSuEfUzfC	姓名
JItzaLGnlXeq	你的性别#R#你了解荆州花鼓戏吗
FXIJSvUoDaKu	确定下单店铺名与产品与任务书一致！拍错无佣金的！使用返利淘宝客追回实际扣款与刷单佣金！#R#确定下单店铺名与产品与任务书一致！拍错无佣金的！使用返利淘宝客追回实际扣款与刷单佣金！#R#旺旺名！也是淘宝会员名！不要发昵称，造成发货的，自己承担寄回邮费！有多个账号的要注意，你用账号A刷单，发账号B的名称会造成真实发货！#R#实际付款金额！店铺优惠券要领！不要用淘金币等！商家只转实际付款金额+5
GXhUANiFyCSv	姓名#R#性别#R#出生日期#R#学院#R#手机号码#R#QQ#R#为什么会考虑加入XX社#R#觉得自己加入XX社的优势#R#对于XX社的看法和建议#R#QQ#R#自我评价#R#意愿部门
cNXJsUklelbX	这是干什么的
cQTwKwnmNDsE	你的服装尺寸#R#总表读数
EsRwDJJnVdTe	姓名#R#性别#R#出生地#R#籍贯#R#身份证号#R#民族#R#政治面貌#R#户口所在地#R#班内学号#R#班级#R#入学年月#R#入学方式#R#就读方式#R#家庭住址#R#QQ号码#R#家庭成员或监护人信息：姓名#R#关系#R#民族#R#工作单位#R#现住址#R#户口所在地#R#家庭成员或监护人的联系电话（手机）#R#是否为监护人#R#联系电话（手机）#R#QQ号码#R#家庭成员或监护人信息：姓名#R#关系
YYbPZOnBrQry	你的姓名#R#你的手机号码#R#你的身份证号码#R#你的邮箱#R#你的性别#R#你的邮箱#R#你的网址#R#你的服装尺寸#R#你的学历#R#你的服装尺寸#R#你的姓名
EZoicjYptoER	你的姓名#R#你的手机号码#R#你的性别#R#你的出生年月
bSDhbdXzQxdo	姓名周康#R#性别#R#出生地#R#籍贯#R#身份证号#R#民族#R#政治面貌#R#户口所在地#R#班内学号#R#班级#R#入学年月#R#入学方式#R#就读方式#R#家庭住址#R#QQ号码#R#家庭成员或监护人信息：姓名#R#关系#R#民族#R#工作单位#R#现住址#R#户口所在地#R#家庭成员或监护人的联系电话（手机）#R#是否为监护人#R#联系电话（手机）#R#QQ号码#R#家庭成员或监护人信息：姓名#R#关系
DHcgpNLlaBhR	你的姓名#R#你的手机号码#R#团员福利免费入场劵#R#团员众筹EP数
JjUFUFCwQrZc	姓名#R#性别#R#出生地#R#籍贯#R#身份证号#R#民族#R#政治面貌#R#户口所在地#R#学院#R#专业班级#R#入学年月#R#入学方式#R#就读方式#R#家庭住址#R#QQ号码#R#家庭成员或监护人信息：姓名#R#微信#R#是否有男（女）朋友（重点：有无避嫌需求）#R#意向（参考项，不保证一定相同）#R#pu学时#R#户口所在地#R#家庭成员或监护人的联系电话（手机）#R#是否为监护人#R#联系电话（手机）#R#QQ号码#R#家庭成员或监护人信息：姓名#R#关系
MPLAcYkMppNh	你的姓名#R#只凭活动的名称和目前有限的了解，你最有意向参与进团委下学期的哪一项活动中？#R#假如你参与进上一问中选择的活动，你希望在这项活动里承担的身份是什么？#R#你认为自己适合上一问选择的特质有哪些？#R#只凭活动的名称和目前有限的了解，你对下面的哪一项活动最没有感觉？#R#只凭活动的名称和目前有限的了解，你对下面的哪一项活动最没有感觉？#R#对选择的活动无感的原因是什么？（非必答）#R#你希望在下学期自己参与的活动中得到什么？（某些能力方面的提升抑或是增加人际交往等等？）#R#未命名的标题
OUFNNCObzPuD	公众号ID#R#公众号名称#R#百家号名称#R#领域#R#联系方式#R#未入驻原因
RzkjgEJhbCFZ	你的姓名#R#孩子的号码#R#孩子的姓名#R#我已经知晓上述足球比赛通知
OdaCTqDLgpnO	你的姓名
bBjPyYqoJxsb	日期#R#销售/BD姓名#R#村超名称#R#村超联系人资料#R#自然村#R#村长资料#R#合作意向#R#合伙人资料#R#合伙人背景说明#R#村超#R#他网宽带数#R#地推姓名#R#备注#R#结果
EpoujgkRzKJl	姓名#R#部门#R#手机号码#R#邮箱#R#课程选择#R#岗位#R#方便参加课程时间#R#近期意向学习内容#R#其他建议
YMuDhoFpzMSv	姓名#R#部门
JWCqMVUaZkAM	姓名#R#性别#R#出生地#R#籍贯#R#身份证号#R#民族#R#政治面貌#R#户口所在地#R#班内学号#R#班级#R#入学年月#R#入学方式#R#就读方式#R#家庭住址#R#QQ号码#R#家庭成员或监护人信息：姓名#R#关系#R#民族#R#工作单位#R#现住址#R#户口所在地#R#家庭成员或监护人的联系电话（手机）#R#是否为监护人#R#联系电话（手机）#R#QQ号码#R#家庭成员或监护人信息：姓名#R#关系
TBttjwUSJHiE	你的姓名
bNmVSUKCHFUK	姓名#R#性别#R#出生地#R#籍贯#R#身份证号#R#民族#R#政治面貌#R#户口所在地#R#班内学号#R#班级#R#入学年月#R#入学方式#R#就读方式#R#家庭住址#R#QQ号码#R#家庭成员或监护人信息：姓名#R#关系#R#民族#R#工作单位#R#现住址#R#户口所在地#R#家庭成员或监护人的联系电话（手机）#R#是否为监护人#R#联系电话（手机）#R#QQ号码#R#家庭成员或监护人信息：姓名#R#关系
TKRkHZNaidPL	彭教练#R#学生1#R#学生2#R#学生3
PPgGpSeedMiV	姓名#R#出生年月#R#身份证号
PuTfRXBRuubS	姓名#R#性别#R#手机#R#QQ号#R#微信号#R#是否住校#R#出生日期#R#家长姓名#R#家长电话（手机）#R#家庭住址
VbAKffvWQxGK	姓名#R#性别#R#出生地#R#籍贯#R#身份证号#R#民族#R#政治面貌#R#户口所在地#R#班内学号#R#班级#R#入学年月#R#入学方式#R#就读方式#R#家庭住址#R#QQ号码#R#家庭成员或监护人信息：姓名#R#关系#R#民族#R#工作单位#R#现住址#R#户口所在地#R#家庭成员或监护人的联系电话（手机）#R#是否为监护人#R#联系电话（手机）#R#QQ号码#R#家庭成员或监护人信息：姓名#R#关系
bCJYDfaFLIgs	取消无任务上传功能，保留无任务下载功能。#R#取消里程桩道路编号和道路名称不能同时为空的控制；增加清空按钮。 当现场里程桩存在有桩号无编号也无名称时，编号和名称不采集即可。#R#地图界面显示车道变化点前后的物理车道数，第1位为变化点前物理车道数，第2位为变化点后物理车道数，中间用“/”分隔，括号中的数字为车道数形成数量，第1个括号是左侧形成数量，第2个括号是右侧形成的数量#R#情报增加备注卡片，填写特殊说明。
NtWFHYeBEaDy	姓名#R#性别#R#出生地#R#籍贯#R#身份证号#R#民族#R#政治面貌#R#户口所在地#R#班内学号#R#班级#R#入学年月#R#入学方式#R#就读方式#R#家庭住址#R#QQ号码#R#家庭成员或监护人信息：姓名#R#关系#R#民族#R#工作单位#R#现住址#R#户口所在地#R#家庭成员或监护人的联系电话（手机）#R#是否为监护人#R#联系电话（手机）#R#QQ号码#R#家庭成员或监护人信息：姓名#R#关系
USmSOrYcLecc	日期#R#销售/BD姓名#R#拜访商家名称#R#商家地点#R#隶属公司#R#商家等级#R#KP（关键人）#R#KP联系电话#R#跟进状态#R#未签约原因
XkBYOiAOBCDo	你的姓名#R#你的姓名
AeHgUXiEXyLM	你的姓名#R#你的性别
TJsFsklNRewR	应给值班老师签到的本子的位置#R#部门及姓名#R#性别#R#吧台垃圾桶归谁倒#R#是否明确通知部员值班期间少玩手机#R#是否去过吧台看过自己部员的值班情况#R#吧台靠门的小桌子上应该摆放什么#R#外来访客 家长 维修人员一定要登记什么#R#值班老师来了值班人员应该做什么#R#戴党徽的人一般是？#R#请假需要备注什么#R#冰箱借用流程#R#微波炉借用流程#R#钥匙借用原则#R#钥匙借用时间限定几分钟#R#同学雨伞归还时值班人员应该做些什么#R#吧台台面上有几本本子以及它们的名字（用途）#R#是否有统一带领部员实地（到吧台）讲过值班细则#R#是否有就值班为主题开过会议或者会议中重点讲解值班细则#R#能不能确定自己的大部分部员了解值班细则#R#值班老师、领导最可能访问时间#R#入学年月#R#入学方式#R#就读方式#R#家庭住址#R#QQ号码#R#家庭成员或监护人信息：姓名#R#关系#R#民族#R#工作单位#R#现住址#R#户口所在地#R#家庭成员或监护人的联系电话（手机）#R#值班请假流程（大致写下自己所认为的）#R#是否为监护人#R#联系电话（手机）#R#QQ号码#R#家庭成员或监护人信息：姓名#R#关系
RddRdwZFWYUL	今天中午我们组一起吃饭，有时间吗？
YkIiFUjffYYx	姓名#R##R#手机#R#QQ号#R#微信号#R#是否住校#R#出生日期#R#家长姓名#R#家长电话（手机）#R#家庭住址
MlRwrQhDePZI	主题清晰度（100分满分）#R#声音洪亮度（100分满分）#R#表达自信度（100分满分）#R#演讲形象（100满分）（站姿、眼神）#R#互动性（100分满分）（眼神互动、邀请听众回答）#R#演讲的吸引力（100分满分）
GeXHPXflVUhl	姓名#R#性别#R#手机#R#QQ号#R#微信号#R#工作或学习的地方#R#出生日期#R#家长姓名#R#家长电话（手机）#R#家庭住址
GCtoxdtUfqTr	你的姓名#R#你的手机号码#R#你的学历
bDAoFtIIPUYP	姓名#R#性别#R#人生格言#R#兴趣爱好#R#身份证号#R#小学简历#R#中学简历#R#户口所在地#R#班内学号#R#班级#R#入学年月#R#入学方式#R#就读方式#R#家庭住址#R#QQ号码#R#家庭成员或监护人信息：姓名#R#关系#R#民族#R#工作单位#R#现住址#R#户口所在地#R#家庭成员或监护人的联系电话（手机）#R#是否为监护人#R#联系电话（手机）#R#QQ号码#R#家庭成员或监护人信息：姓名#R#关系
CbUZrMGOLaZx	你的姓名#R#你的手机号码
OoMDKmRaSqEV	姓名#R#性别#R#出生地#R#籍贯#R#身份证号#R#民族#R#政治面貌#R#户口所在地#R#班内学号#R#班级#R#入学年月#R#入学方式#R#就读方式#R#家庭住址#R#QQ号码#R#家庭成员或监护人信息：姓名#R#关系#R#民族#R#工作单位#R#现住址#R#户口所在地#R#家庭成员或监护人的联系电话（手机）#R#是否为监护人#R#联系电话（手机）#R#QQ号码#R#家庭成员或监护人信息：姓名#R#关系
ZtRKqoYCjldI	姓名#R#性别#R#出生日期#R#学院#R#手机号码#R#QQ#R#为什么会考虑加入XX社#R#觉得自己加入XX社的优势#R#对于XX社的看法和建议#R#QQ#R#自我评价#R#意愿部门
GntfwPhWJVbd	订单序号#R#订单品类#R#订单编号#R#提交者姓名#R#提交时间#R#备注
QiRUHCYDSYom	你的姓名
TSlOSaaNfFdC	是发送到发送到#R#沃尔沃若翁
SkZLsRcReboc	你的姓名#R#你所在学校#R#你学校寒假放假时间#R#你的学历
dTDGWUOLitIJ	寝室号#R#习苑#R#寝室长姓名#R#寝室成员姓名
CaFqlgheUlRi	无
ASZvVKsyRuAy	你的姓名#R#你的姓名
CPeLvZxtihrG	姓名#R#性别#R#手机#R#QQ号#R#微信号#R#是否住校#R#出生日期#R#家长姓名#R#家长电话（手机）#R#家庭住址
bEMDlWdkvXbl	姓名#R#性别#R#手机#R#QQ号#R#微信号#R#是否住校#R#出生日期#R#家长姓名#R#家长电话（手机）#R#家庭住址
CqSYmXJYkayr	你的姓名#R#你的学号
NvIyRtrQEBzJ	家长姓名#R#电话号码
XbyFgqvUnkCY	举报人姓名#R##R#举报人QQ号#R##R#时间#R##R##R#课程选择#R#岗位#R#方便参加课程时间#R#近期意向学习内容#R#举报原因#R#
AJmJxFjfvSRz	姓名#R#是否订购《创意思维》这本书？价格是29.30元
dNlcDeHEBgVz	单位名称（全称）#R#业务需求#R#单位类别#R#所属行业及业务#R#企业上年度记账收入#R#联系人姓名#R#联系电话#R#企业上年度纳税金额
BbVFstsXdjAW	你的姓名#R#你的手机号码#R#你的身份证号码#R#你的性别#R#子女教育#R#您的部门
VgFOQlHvqdsb	你的姓名#R#你的手机号码#R#你的邮箱
faQeixsiHitR	姓名#R#观影人数#R#部门#R#手机号码#R#观影人数#R#课程选择#R#岗位#R#方便参加课程时间#R#近期意向学习内容#R#其他建议
QnAWRjNrupzv	一级类目#R#券数量#R#店铺名称#R#店铺id#R#券面额
BYVayNqQgIXT	
ZvwvkBVOECmZ	姓名#R#性别#R#出生地#R#籍贯#R#身份证号#R#民族#R#政治面貌#R#户口所在地#R#学号#R#班级#R#入学年月#R#入学方式#R#就读方式#R#家庭住址#R#QQ号码#R#家庭成员或监护人信息：姓名#R#关系#R#民族#R#工作单位#R#现住址#R#户口所在地#R#家庭成员或监护人的联系电话（手机）#R#是否为监护人#R#联系电话（手机）#R#QQ号码#R#家庭成员或监护人信息：姓名#R#关系
PmHKNwSnugKf	姓名#R#性别#R#出生日期#R#学院#R#手机号码#R#QQ#R#为什么会考虑加入XX社#R#觉得自己加入XX社的优势#R#对于XX社的看法和建议#R#QQ#R#自我评价#R#意愿部门
JrPGFbGWcvDS	您的性别#R#您来自哪里#R#您了解荆州花鼓戏吗#R#您多久看一次花鼓戏#R#您了解荆州花鼓戏的渠道（多选）#R#您觉得荆州花鼓戏活跃于哪些场合？（多选）#R#您对荆州花鼓戏满意的地方？（多选）#R#您对荆州花鼓戏不满意的地方？（多选）#R#您认为对荆州花鼓戏等非物质文化遗产进行传承重要吗？#R#您认为荆州花鼓戏的前景如何？
ffOJfQPmqZmm	姓名#R#工作类型#R#平台#R#工作接待量#R#提交时间
aXyACMxMvhAC	姓名#R#性别#R#手机#R#QQ号#R#微信号#R#是否住校#R#出生日期#R#家长姓名#R#家长电话（手机）#R#家庭住址
EqfeAGbAduzN	姓名#R#姓氏拼音#R#名字拼音#R#性别#R#考试科目
TJjPzLEavWhG	姓名#R#性别#R#手机#R#QQ号#R#微信号#R#是否住校#R#出生日期#R#家长姓名#R#家长电话（手机）#R#家庭住址
QqPmzQdeVbwK	你的手机号码
FRWprPXSnJFi	姓名#R#性别#R#出生地#R#籍贯#R#身份证号#R#民族#R#政治面貌#R#户口所在地#R#班内学号#R#班级#R#入学年月#R#入学方式#R#就读方式#R#家庭住址#R#QQ号码#R#家庭成员或监护人信息：姓名#R#关系#R#民族#R#工作单位#R#现住址#R#户口所在地#R#家庭成员或监护人的联系电话（手机）#R#是否为监护人#R#联系电话（手机）#R#QQ号码#R#家庭成员或监护人信息：姓名#R#关系
YfQBGdlLsBkk	亲的宿舍楼宿舍号？#R#宿舍楼宿舍号#R#取件码#R#亲的姓名#R#完整电话号码#R#快递网点名称
VTFYXUnbphiP	城市#R#当天销售额#R#当月累计销售额#R#当天毛利#R#当月累计毛利#R#当天毛利率（%）#R#当月毛利率（%）#R#社群总用户#R#店铺访问人数#R#单日ARPU
JIWwCfpOJgCq	申挂否？#R#叙续否？
WfyGHysfQnvf	你的姓名#R#你的手机号码#R#班级
EKXiXVDGoUdA	企业微信或者钉钉选择
VgHmeCrkkqqH	姓名#R#性别#R#手机#R#QQ号#R#微信号#R#是否住校#R#出生日期#R#家长姓名#R#家长电话（手机）#R#家庭住址
VfeUoOrcxIfi	你的姓名#R#工作号#R#所属中心或部门#R#工作描述#R#所属中心部门
WWAZFGAzXSEM	今天吃了几次饭？
TpIwJarLXYef	姓名#R#性别#R#出生日期#R#学院#R#手机号码#R#QQ#R#为什么会考虑加入XX社#R#觉得自己加入XX社的优势#R#对于XX社的看法和建议#R#QQ#R#自我评价#R#意愿部门
GiCdfTolWcNd	学院#R#专业班级#R#姓名#R#手机号码#R#身份证号码
UeRYkGyIQsaY	达成工作目标#R#拜访客户名称#R#日期#R#团队人员姓名#R#团队成员姓名#R#客户地点#R#隶属上级单位#R#商家等级#R#营销关键人#R#姓名)#R#营销关键人联系电话#R#营销进展#R#下周工作安排#R#遇到问题
PEqhmmtoESni	姓名#R#想应聘什么职位鸭#R#性别#R#出生日期#R#学院#R#手机号码#R#QQ#R#为什么会考虑加入XX社#R#觉得自己加入XX社的优势#R#对于XX社的看法和建议#R#QQ#R#自我评价#R#意愿部门
KgZAzULdOhCp	你来自于那个事业部#R#你来自于那个咨询组#R#你认为自己的优势以及对自己的评价#R#作为最棒的你给事业部或是公司的建议是#R#邮箱#R#课程选择#R#岗位#R#方便参加课程时间#R#近期意向学习内容#R#你对于直属主管的培养建议是
ARhwMguUWOfD	你的性别#R#你的学历#R#毕业证#R#你很棒#R#有红包，抢是不抢
AKxMiwNQLzsY	姓名#R#性别#R#出生地#R#籍贯#R#身份证号#R#民族#R#政治面貌#R#户口所在地#R#班内学号#R#班级#R#入学年月#R#入学方式#R#就读方式#R#家庭住址#R#QQ号码#R#家庭成员或监护人信息：姓名#R#关系#R#民族#R#工作单位#R#现住址#R#户口所在地#R#家庭成员或监护人的联系电话（手机）#R#是否为监护人#R#联系电话（手机）#R#QQ号码#R#家庭成员或监护人信息：姓名#R#关系
IhtITqnuaybr	写作时间#R#今天心情#R#日记
PXhZIcUMUhrM	商品id#R#商品名称#R#商品评价#R#提报人#R#类目#R#拼团价#R#秒杀价#R#件数#R#审核人#R#店铺负责人#R#店铺名称#R#店铺id#R#秒杀商品id
EuBUMuUAnEnM	旧的资料
QSxonogRTPzl	实验1#R#学号#R#姓名#R#实验2#R#实验3#R#实验4#R#实验5#R#实验6#R#实验7#R#实验8#R#实验9#R#实验10#R#实验11#R#实验12
BBxCnmFfQLmM	供应商名称#R#供应商平台#R#供货名称#R#商品规格#R#商品链接#R#商品价格#R#备注
TpKZLeppttqa	CN#R#性别#R#身高#R#体重#R#出生年月#R#现在所在地#R#SIZE#R#QQ#R#微信#R#手机#R#所在学校/单位#R#空闲时间#R#技能#R#作品（可填写名称，图片、生活照私发管理）#R#其他技能（补充说明）#R#寄语#R#微博
BShxSUcPcNkv	名字#R#回家日期#R#联系电话
FBJlziEGLsuC	周末加班申请
WbDUqABKvMjz	姓名#R#性别#R#出生日期#R#学院#R#手机号码#R#QQ#R#为什么会考虑加入XX社#R#觉得自己加入XX社的优势#R#对于XX社的看法和建议#R#优点#R#QQ#R#自我评价#R#意愿部门
JhgjBcwvXLCi	你的姓名#R#你的手机号码#R#你的手机号码#R#所担任的院、系职务（全称）#R#你的学号
ZIEDnvDcWDhf	你的姓名
ajuZKOQzpTwL	你的姓名
HgNyrCwnvnQE	你的姓名
PlxjCiOHRUYc	你的姓名#R#Communication Electronic Circuits#R#单片机原理及应用技术#R#电磁场与电磁波#R#固体物理基础#R#数字信号处理#R#通信电子线路实践教程-设计与仿真
MFFHxspsWfev	姓名#R#性别#R#出生日期#R#学院#R#手机号码#R#QQ#R#为什么会考虑加入XX社#R#觉得自己加入XX社的优势#R#对于XX社的看法和建议#R#QQ#R#自我评价#R#意愿部门
WzTVkyqjGZBE	你认为你现在一周的课程多吗？#R#一周中你认为留给你自己支配的时间合适吗？#R#你现在是否已习惯当前的教学模式？#R#毕业后你是考研还是参加工作？#R#空课时间你会用来做什么？#R#没课的早晨你会坚持早起吗？#R#你认为上早晚自习有必要吗？#R#你认为你目前对自己空课时间安排合理吗？
ASiaNzMGKUnf	口红单号
ZDZSRJhehCcF	姓名#R#性别#R#出生地#R#籍贯#R#身份证号#R#民族#R#政治面貌#R#户口所在地#R#班内学号#R#班级#R#入学年月#R#入学方式#R#就读方式#R#家庭住址#R#QQ号码#R#家庭成员或监护人信息：姓名#R#关系#R#民族#R#工作单位#R#现住址#R#户口所在地#R#家庭成员或监护人的联系电话（手机）#R#是否为监护人#R#联系电话（手机）#R#QQ号码#R#家庭成员或监护人信息：姓名#R#关系
TcOKZPNqKmFR	姓名#R#性别#R#出生日期#R#学院#R#手机号码#R#QQ#R#为什么会考虑加入XX社#R#觉得自己加入XX社的优势#R#对于XX社的看法和建议#R#QQ#R#自我评价#R#意愿部门
RVcyiWTGkOCK	姓名
dCwVzkjFQGgq	ZD小
YzBmtUuUOGyX	姓名#R#性别#R#出生地#R#籍贯#R#身份证号#R#民族#R#政治面貌#R#户口所在地#R#班内学号#R#班级#R#入学年月#R#入学方式#R#就读方式#R#家庭住址#R#QQ号码#R#家庭成员或监护人信息：姓名#R#关系#R#民族#R#工作单位#R#现住址#R#户口所在地#R#家庭成员或监护人的联系电话（手机）#R#是否为监护人#R#联系电话（手机）#R#QQ号码#R#家庭成员或监护人信息：姓名#R#关系
KlWdlXnDAmlq	你的姓名#R#你的身份证号码#R#准考证号
NmnxGgkzBgOR	家长姓名#R#电话号码
BUjvZQkgExaI	你的姓名
BDPwkpBNaWsC	问题标题11.3088485851
TdnyFRBZbVsi	CN#R#电话#R#服装#R#是否决定去#R#摄影师选填
QQaXaMOMQWQa	姓名#R#性别#R#出生地#R#籍贯#R#身份证号#R#民族#R#政治面貌#R#户口所在地#R#班内学号#R#班级#R#入学年月#R#入学方式#R#就读方式#R#家庭住址#R#QQ号码#R#家庭成员或监护人信息：姓名#R#关系#R#民族#R#工作单位#R#现住址#R#户口所在地#R#家庭成员或监护人的联系电话（手机）#R#是否为监护人#R#联系电话（手机）#R#QQ号码#R#家庭成员或监护人信息：姓名#R#关系
WKzIRbolamFQ	姓名#R#性别#R#出生日期#R#学院#R#手机号码#R#QQ#R#为什么会考虑加入XX社#R#觉得自己加入XX社的优势#R#对于XX社的看法和建议#R#QQ#R#自我评价#R#意愿部门
PaFHSvmGRSAb	问题标题16.3185818493#R#问题标题16.3185818493
RklANXVRuQzq	是否独生子女#R#每周与家人联系几次#R#与父母主要通过什么方式联系？#R#你与父母联系的目的？#R#是否主动联系父母？#R#你认为与父母关系如何？#R#想念家中的什么？#R#与父母哪方更亲近？#R#在通话中会时常关心父母的生活吗？#R#你对现今中国的老龄化问题有多少了解
OyWFKvaUgmyA	姓名#R#性别#R#手机#R#QQ号#R#微信号#R#是否住校#R#是否有代谢性问题#R#出生日期#R#家长姓名#R#家长电话（手机）#R#家庭住址
DRdnQIqfvuPg	姓名：#R#通信电源中开关电源的浮充电压值由什么决定（ ）#R#分流器的作用是 （ ）#R#当市电正常时，整流器一方面向负荷供电，另一方面给蓄电池以一定的补充电流，此时，整流器上显示的输出电压值是( )。#R#蓄电池均充补充电电压在2.30~2.35V之间，理论上不应超过 （ ）V，否则会造成电池大量排气而失水。#R#C10 代号的含义为（ ）#R#控式密封铅酸蓄电池内部使用的酸性物质为（ ）#R#室温25℃下，48V阀控式密封铅酸蓄电池组浮充电压一般为（ ）左右。#R#油机发电机组的交流输出整定电压是在什么运行情况下调整的（ ）#R#直击雷的防护原则主要是设法使雷电流迅速泻放到大地中去，下面（ ）#R#将工作地、保扩地和防雷地共同合用一组接地体的方式称为（ ）。 #R#【填空】业务故障时，应遵循 先（ ）后（ ）；先 ( )后（ ）；先 本端 ，后对端；先网内，后网外，分故障等级进行处理”的总原则进行故障处理。#R#SPD接地必须接入 （ ） 地排；MU接地必须接入 （ ）地排。#R#爱立信LTE基站设备一块DUS板最多可以支持 （ ） 台RRU。#R#GPS馈线长度超过 （ ） 米须加装放大器。#R#中兴LTE基站设备8通道RRU光模块必须是 （ )G光模块，传输光模块必须是 ( ) G光模块。#R#驻波比告警的合理范围是（ ）之间#R#目前爱立信基站维护备件实行紧急备件处理流程，（ ）小时内到达现场，确保日常维护的正常开展。#R#基站退服平均时长标砖是 ：A类≤（ ）分钟，B类≤（ ）分钟，C类≤（ ）分钟#R#超频掉站是怎么定义的？#R#综合代维协议规定，移网每月工单完成率在（ ）%以下的，一次性扣当月代维考核分4分，未完成工单累积到下月再统计。#R#LTE RRU在网络要求≥（ ）%，RRU在服率要求≥（ ）%#R#A、B类站点巡检周期为（ ）个月，C类站点巡检周期为（ ）个月。
VjfIJCtSVkZy	省区#R#城市#R#办事处#R#负责业务员姓名#R#业务员联系方式#R#医院名称#R#科室#R#研究者姓名#R#行政职务#R#职称#R#科研经验#R#研究团队#R#是否开展过或即将开展PD-1研究#R#研究者目前已使用PD-1情况#R#申请的研究方案的创新性 #R#数据处理水平#R#论文写作和发表水平 #R#预期发表的杂志级别#R#期望入组例数#R#近 1 年内符合入组方向的患者数#R#平均每个月入组进度（注：进度=每月入组患者数/总样本量 ）#R#赠药要求 （注：赠药比例=赠药数量/自然买药销量）#R#期望开展研究种类#R#期望研究瘤种（可填多个）#R#PD-1课题方向（简述即可，疾病、线数、用药方案、创新点）#R#简述目前使用过PD-1用药经验情况（药品名称、用药方案、用药周期、患者状态）
WDiUMFeSzkLZ	项目#R#二级财务（姓名）#R#报考考试#R#通过考试
LRNdJqpbefPr	姓名#R#性别#R#手机#R#QQ号#R#微信号#R#是否住校#R#出生日期#R#家长姓名#R#家长电话（手机）#R#家庭住址
HwKYureOAHfp	你的姓名做单位名称？
VOShiISpqDNw	昵称#R#性别#R#出生日期#R#QQ#R#自我介绍#R#QQ#R#为什么会考虑加入本社#R#你能在多短时间内融进集体#R#籍贯#R#对于本社的看法和建议#R#QQ#R#自我评价#R#意愿部门
ThlncaCMSzMD	你在下面的护理人员选择最好的
GiwYIUiPjriM	你的姓名
EnPMKeiadLje	你的姓名
eFMhamylejty	你的姓名#R#班级#R#生源地#R#贷款金额#R#班级
PfWtXhHdWCJO	姓名#R#性别#R#出生地#R#籍贯#R#身份证号#R#民族#R#政治面貌#R#户口所在地#R#班内学号#R#班级#R#入学年月#R#入学方式#R#就读方式#R#家庭住址#R#QQ号码#R#家庭成员或监护人信息：姓名#R#关系#R#民族#R#工作单位#R#现住址#R#户口所在地#R#家庭成员或监护人的联系电话（手机）#R#是否为监护人#R#联系电话（手机）#R#QQ号码#R#家庭成员或监护人信息：姓名#R#关系
SdyBevMsafmh	日志
RpjRrGyQZkHy	你的手机号码
JEUFnJrxXlmi	门店店编#R#门店名称#R#顾客姓名#R#顾客电话#R#购买商品#R#收取金额
GqVLAidHgeso	您的姓名#R#公司/团队名称#R#岗位职级#R#岗位职级#R#联系电话（手机）
fCFdsVlQjmFs	我家小胖纸可不可爱
DOTCAIRCIFTn	塘屿村委会#R#土地
SwVEbZFcOqmJ	姓名#R#性别#R#手机#R#QQ号#R#微信号#R#是否住校#R#出生日期#R#家长姓名#R#家长电话（手机）#R#家庭住址
PMFEQQMfnJhM	姓名#R#性别#R#出生地#R#籍贯#R#身份证号#R#民族#R#政治面貌#R#户口所在地#R#班内学号#R#班级#R#入学年月#R#入学方式#R#就读方式#R#家庭住址#R#QQ号码#R#家庭成员或监护人信息：姓名#R#关系#R#民族#R#工作单位#R#现住址#R#户口所在地#R#家庭成员或监护人的联系电话（手机）#R#是否为监护人#R#联系电话（手机）#R#QQ号码#R#家庭成员或监护人信息：姓名#R#关系
cXLHRxOMepUX	去哪吃#R#吃啥
UEddVDzDuVFD	请为你心中的“班级之星”投票（投一人）#R#请为你心中的“优秀个人”投票（投三人）
YLeKgkczEnMZ	您的姓名#R#公司/团队名称#R#岗位职级#R#岗位职级#R#联系电话（手机）
NIQDvNdXqiky	问题标题14.0410996115
GdIDDbSIrHoi	请填写你认为恒定电流练习卷中需要评讲的题目序号：#R#还有其它问题吗？
ELjKPRzrCaEq	姓名#R#性别#R#出生年月#R#籍贯#R#毕业院校#R#工作单位#R#电话号码#R#兴趣爱好#R#论文方向#R#导师姓名
AIVhsPDVQhEI	姓名#R#学号#R#性别#R#专业#R#是否组队#R#有问题可以加数学建模交流群838466169，我们会为您解答#R#出生日期#R#学院#R#手机号码#R#QQ#R#为什么会考虑加入XX社#R#觉得自己加入XX社的优势#R#对于XX社的看法和建议#R#QQ#R#自我评价#R#意愿部门
GxOMXAnjzRAo	您的姓名#R#您的邮箱#R#您服务的部门#R#您的职务#R#出生地#R#所属紫金矿业集团下属海外矿山名称#R#身份证号#R#海外项目地隶属国名称#R#海外项目地的官方语言#R#海外项目地是否缺乏懂汉语和当地语言的技术人员#R#目前紧缺急需矿业人才所属的专业#R#项目地所属国是否有地矿类高等院校？如果有，院校名称和地矿专业是什么？#R#当地潜在地矿类人才生源#R#是否有意向“丝绸之路”毕业生加盟紫金矿业集团#R#关于紫金矿业集团国际化矿业人才培养的建议#R#你认为集团国际化矿业人才培养的突出问题是什么？#R#家庭住址#R#QQ号码#R#家庭成员或监护人信息：姓名#R#关系#R#民族#R#工作单位#R#现住址#R#户口所在地#R#家庭成员或监护人的联系电话（手机）#R#是否为监护人#R#联系电话（手机）#R#QQ号码#R#家庭成员或监护人信息：姓名#R#关系
LzPuDRjXWbbx	你的身份证号码#R#你的入党申请书年月
RRALazFYLIhc	姓名#R#性别#R#手机#R#QQ号#R#微信号#R#是否住校#R#出生日期#R#家长姓名#R#家长电话（手机）#R#家庭住址
dyqsOwvrFdNi	你的网址#R#你的邮箱#R#你的出生年月
ZAUbRQGFPeMq	名称#R#进价#R#零售价
HTIYohUiPrGE	你的性别
PNbFyfOHBqXh	你的姓名
TeapeyBydgJA	姓名#R#性别#R#出生日期#R#学院#R#手机号码#R#QQ#R#为什么会考虑加入XX社#R#觉得自己加入XX社的优势#R#对于XX社的看法和建议#R#QQ#R#自我评价#R#意愿部门
MGaxJyxzREpK	主题清晰度（100分满分）#R#声音洪亮度（100分满分）#R#表达自信度（100分满分）#R#演讲形象（100满分）（站姿、眼神）#R#互动性（100分满分）（眼神互动、邀请听众回答）#R#演讲的吸引力（100分满分）
WXjsIYMcqDHC	#R#2018
BQLpLMindPsY	姓名#R#部门#R#手机号码#R#邮箱#R#课程选择#R#岗位#R#方便参加课程时间#R#近期意向学习内容#R#其他建议
FsEUDqBorCBI	你的手机号码#R#你的姓名
ZidNJCIcVIXx	你的姓名#R#你的手机号码#R#你的性别#R#你的班级#R#你的邮箱
JzAOzbExiBgd	你的姓名#R#你的手机号码#R#你的身份证号码#R#你的邮箱#R#你的性别#R#你的出生年月
EUTtGPuvVsbI	你的姓名
SMCgtJHUppLP	你的姓名#R#你的手机号码#R#你的邮箱
MpoRnwyRQZsO	主题清晰度（100分满分）#R#声音洪亮度（100分满分）#R#表达自信度（100分满分）#R#演讲形象（100满分）（站姿、眼神）#R#互动性（100分满分）（眼神互动、邀请听众回答）#R#演讲的吸引力（100分满分）
ewElJGVYOdkB	日期#R#销售/BD姓名#R#拜访商家名称#R#商家地点#R#隶属公司#R#商家等级#R#KP（关键人）#R#KP联系电话#R#跟进状态#R#未签约原因
GhNAuxawPkoy	姓名#R#性别#R#出生地#R#籍贯#R#身份证号#R#民族#R#政治面貌#R#户口所在地#R#班内学号#R#班级#R#入学年月#R#入学方式#R#就读方式#R#家庭住址#R#QQ号码#R#家庭成员或监护人信息：姓名#R#关系#R#民族#R#工作单位#R#现住址#R#户口所在地#R#家庭成员或监护人的联系电话（手机）#R#是否为监护人#R#联系电话（手机）#R#QQ号码#R#家庭成员或监护人信息：姓名#R#关系
GZFRkKUZoBXs	178260
IZTTvHHBtvkw	姓名#R#性别#R#出生日期#R#学院#R#手机号码#R#QQ#R#为什么会考虑加入XX社#R#觉得自己加入XX社的优势#R#对于XX社的看法和建议#R#QQ#R#自我评价#R#意愿部门
WSxsCiElrLgD	姓名#R#性别#R#出生地#R#籍贯#R#身份证号#R#民族#R#政治面貌#R#户口所在地#R#班内学号#R#班级#R#入学年月#R#入学方式#R#就读方式#R#家庭住址#R#QQ号码#R#家庭成员或监护人信息：姓名#R#关系#R#民族#R#工作单位#R#现住址#R#户口所在地#R#家庭成员或监护人的联系电话（手机）#R#是否为监护人#R#联系电话（手机）#R#QQ号码#R#家庭成员或监护人信息：姓名#R#关系
CVnVpGGvLVmc	你的邮箱
fknLXpOnfvIb	姓名#R#性别#R#手机#R#QQ号#R#微信号#R#是否住校#R#出生日期#R#家长姓名#R#家长电话（手机）#R#家庭住址
RosbOlOwBVaR	你的真实姓名#R#你的微信号#R#问题1：请详细描述#R#问题2：请详细描述
RtjPOrXPxfXS	问题标题17.8918452712#R#问题标题17.8918452712
TcjAqBhNbXHQ	师傅师傅说#R#师傅师傅说222#R#师傅师傅说222#R#师傅师傅说222
bwAPlhaYkygf	姓名#R#性别#R#出生地#R#籍贯#R#身份证号#R#民族#R#政治面貌#R#户口所在地#R#班内学号#R#班级#R#入学年月#R#入学方式#R#就读方式#R#家庭住址#R#QQ号码#R#家庭成员或监护人信息：姓名#R#关系#R#民族#R#工作单位#R#现住址#R#户口所在地#R#家庭成员或监护人的联系电话（手机）#R#是否为监护人#R#联系电话（手机）#R#QQ号码#R#家庭成员或监护人信息：姓名#R#关系
QluWiyPZHywT	你的手机号码1536888929
aGqqHieQMAtD	客户姓名#R#客户用户名#R#部门#R#客户公司名称#R#客户公司所属行业#R#客户手机号码#R#客户使用产品#R#客户使用情况反馈#R#邮箱#R#课程选择#R#岗位#R#方便参加课程时间#R#未命名的标题#R#其他建议
JPZVIkRffMBm	其他建议#R#倾向于哪种提成办法,请选择
OZSTGkPJYYxZ	旺旺名#R#书名#R#类型#R#作者#R#台币#R#出版社#R#数量
OCudtstNlByK	你的姓名
LStdgKJvclKm	姓名#R#性别#R#出生地#R#籍贯#R#身份证号#R#民族#R#政治面貌#R#户口所在地#R#班内学号#R#班级#R#入学年月#R#入学方式#R#就读方式#R#家庭住址#R#QQ号码#R#家庭成员或监护人信息：姓名#R#关系#R#民族#R#工作单位#R#现住址#R#户口所在地#R#家庭成员或监护人的联系电话（手机）#R#是否为监护人#R#联系电话（手机）#R#QQ号码#R#家庭成员或监护人信息：姓名#R#关系
OnzZXXMqpANE	你的姓名
JadRuFgvcnVE	关于会员会费#R#您对协会有哪些建议？#R#您对协会的章程讨论稿是否认同？#R#如果收取会费，您认为会费一年多少合适？#R#您希望协会组织哪些方面的活动？#R#您期望协会其他的活动有哪些？#R#您对协会的章程讨论稿是否认同？
KVFqIPkBRkJn	你的姓名#R#你的手机号码#R#你的身份证号码#R#你的邮箱
azFjQzyKxIEZ	姓名#R#详细#R#职业
MCkDCiRCbyCp	你的身份证号码
DOgaBqRJHPJr	您的姓名#R#公司/团队名称#R#不能参加的原因#R#岗位职级#R#联系电话（手机）
VgcxTTpzCtUc	姓名#R#学号#R#班级#R#工作时间#R#00-14#R#00）#R#00-16#R#00）#R#00-17#R#00）#R#性别#R#出生日期#R#学院#R#手机号码#R#QQ#R#为什么会考虑加入XX社#R#觉得自己加入XX社的优势#R#对于XX社的看法和建议#R#QQ#R#自我评价#R#意愿部门
WmsMDuEnxwcp	姓名#R#性别#R#是否愿意参加本次冬令营项目组#R#出生地#R#籍贯#R#身份证号#R#民族#R#是否已经购买回家的票#R#最后一门考完时间#R#班内学号#R#班级#R#入学年月#R#入学方式#R#就读方式#R#家庭住址#R#QQ号码#R#家庭成员或监护人信息：姓名#R#关系#R#民族#R#工作单位#R#现住址#R#户口所在地#R#家庭成员或监护人的联系电话（手机）#R#是否为监护人#R#联系电话（手机）#R#QQ号码#R#家庭成员或监护人信息：姓名#R#关系
NKxFGXIzBuaS	学号#R#你的名字
DzHoZhfAPrYC	【判断题】设备接地的目的是保障设备运行的安全正常，为设备提供抗击外来电磁干扰的能力，避免在遭受雷击的情况下设备发生故障 。#R#姓名：#R#【判断题】使用驻波比测试仪时，如果测量馈线中有塔放，或干线放大器等有源设备，为了保证测量的准确性，需要将有源设备断电后再测量。#R#【判断题】为满足室内覆盖中多系统合路建设的需求，一般都采用宽频段的元器件，比如800-2500Mhz的耦合器。#R#【判断题】为满足室内覆盖中多系统合路建设的需求，一般都采用宽频段的元器件，比如800-2500Mhz的耦合器。#R#【判断题】在话务高峰时段，可以对商用局或试运行设备进行局数据的更改。#R#【判断题】机械下倾角的另一个缺陷是天线后瓣会上翘，对相邻扇区造成干扰，引起近区高处用户手机掉话。#R#【判断题】定向天线安装在楼顶时，要求支架必须安装有避雷针，支架和建筑物避雷网不能连通。#R#【判断题】一般来说，馈线弯曲半径越小越好，这样有利于馈线排布的美观性。#R#【判断题】天线各个端口之间的隔离度应大于30dB。#R#【判断题】在制冷循环中，制冷剂在蒸发器中吸收的热量与在冷凝器中放出的热量相等#R#【判断题】通信电源在绝大部分应用场合下，偶尔需要配置一定容量的蓄电池，保证通信设备在市电异常的情况下能够不间断地工作。 #R#【判断题】影响电池寿命的因素包括： 环境温度，避免大电流充电，避免过放电，均衡充电，最好能定期小电流放电。 #R#【判断题】为了补充蓄电池由于自身放电而失去的那部分能量，充电器以很大的电流进行补充，以免由于自身损失太多而影响外电网停电时的备用效果。 #R#【判断题】防雷设备的维护主要要求是维持防雷设备指示正常、无发热异常现象。 #R#【判断题】通信机房内所有电力电缆应采用阻燃性电缆；电源线应采用铜线，铜线铝线可相接；接头处安装封闭式接线盒。 #R#【判断题】基站割接或搬迁时，时间可由代维队伍自行决定。#R#【判断题】由于冬天气温较低，发电时油机可放置在基站内，关闭基站们保温。
PHhHDWWGLIaO	姓名#R#部门#R#手机号码#R#生日#R#家庭地址#R#爱好#R#课程选择#R#爱好#R#方便参加课程时间#R#近期意向学习内容#R#生日（农历）
XWcHcZwUOGhh	姓名#R#性别#R#手机#R#QQ号#R#微信号#R#是否住校#R#出生日期#R#家长姓名#R#家长电话（手机）#R#家庭住址
XiuIcsDkaiDl	姓名#R#性别#R#出生地#R#籍贯#R#身份证号#R#民族#R#政治面貌#R#户口所在地#R#班内学号#R#班级#R#入学年月#R#入学方式#R#就读方式#R#家庭住址#R#QQ号码#R#家庭成员或监护人信息：姓名#R#关系#R#民族#R#工作单位#R#现住址#R#户口所在地#R#家庭成员或监护人的联系电话（手机）#R#是否为监护人#R#联系电话（手机）#R#QQ号码#R#家庭成员或监护人信息：姓名#R#关系
bdvwagqfiYEV	姓名#R#性别#R#出生地#R#籍贯#R#身份证号#R#民族#R#政治面貌#R#户口所在地#R#班内学号#R#班级#R#入学年月#R#入学方式#R#就读方式#R#家庭住址#R#QQ号码#R#家庭成员或监护人信息：姓名#R#关系#R#民族#R#工作单位#R#现住址#R#户口所在地#R#家庭成员或监护人的联系电话（手机）#R#是否为监护人#R#联系电话（手机）#R#QQ号码#R#家庭成员或监护人信息：姓名#R#关系
RjixMzJriBXx	本人所属分院#R#姓名#R#工号#R#未命名的标题#R#职责#R#开始日期#R#截止日期#R#授课省份+城市#R#学员组成（总人数+各学科学段具体分布）#R#课程名称
FunewKPyImoD	姓名#R#性别#R#手机#R#QQ号#R#微信号#R#是否住校#R#出生日期#R#家长姓名#R#家长电话（手机）#R#家庭住址
fLiTVOqyuync	日期#R#销售/BD姓名#R#拜访商家名称#R#商家地点#R#隶属公司#R#商家等级#R#KP（关键人）#R#KP联系电话#R#跟进状态#R#未签约原因
FzXgBKJNmqGV	你所拍免单#R#订单编号#R#谁送给你免单
JdWdwcBqXYbx	你觉得这
EMGnuxLqbRTR	姓名#R#性别#R#手机#R#QQ号#R#微信号#R#是否住校#R#出生日期#R#家长姓名#R#家长电话（手机）#R#家庭住址
dUAySiRqcGoP	12月30日#R#1月13日#R#姓名#R#性别#R#出生日期#R#12月23日#R#12月30日#R#QQ#R#1月20日#R#1月27日#R#对于XX社的看法和建议#R#QQ#R#1月6日#R#意愿部门
GAoNBdgSGfke	姓名#R#性别#R#出生日期#R#学院#R#手机号码#R#QQ#R#为什么会考虑加入XX社#R#觉得自己加入XX社的优势#R#对于XX社的看法和建议#R#QQ#R#自我评价#R#意愿部门
eFJJiqIMUVYK	你的姓名
VcecKnvFbKAO	日期#R#销售/BD姓名#R#拜访商家名称#R#商家地点#R#隶属公司#R#商家等级#R#KP（关键人）#R#KP联系电话#R#跟进状态#R#未签约原因
CLTNBAGJxIPs	你的微信昵称-下单价格#R#拍的产品#R#下单价格#R#订单编号#R#订单编号#R#谁送你的免单#R#你的邮箱
FhqznjyYwaNQ	姓名#R#性别#R#出生日期#R#学院#R#手机号码#R#QQ#R#为什么会考虑加入XX社#R#觉得自己加入XX社的优势#R#对于XX社的看法和建议#R#QQ#R#自我评价#R#意愿部门
WDPYwcrGXuKS	姓名#R#性别#R#出生日期#R#学院#R#手机号码#R#QQ#R#为什么会考虑加入XX社#R#觉得自己加入XX社的优势#R#对于XX社的看法和建议#R#QQ#R#自我评价#R#意愿部门
GZDEIyUtCHWy	姓名#R#学号
FkMZZqkUVaxt	 中国诗词大会
DASrpxaaLVRA	你的网址
BjWfCnMNEEIV	Please rate the course organization for microbiology#R#Please rate the teaching quality for microbiology#R#What feedback do you have for microbiology?#R#Please rate the teaching quality for parasitology#R#Please rate the course organization for parasitology#R#Please rate the teaching quality for pathology#R#Please rate the course organization for pathology#R#What feedback do you have for parasitology?#R#Please rate the teaching quality for pathophysiology#R#Please rate the course organization for pathophysiology#R#What feedback do you have for pathophysiology?#R#Please rate the teaching quality for PBL#R#Please rate the course organization for PBL#R#What feedback do you have for PBL?#R#What feedback do you have for PBL?#R#What feedback do you have for administration?#R#What other feedback do you have?#R#3#R#What feedback do you have for pathology?
RtRHQfcvejra	你的手机号码#R#常用称呼#R#是否开车#R#出发坐标#R#人数#R#你的姓名
SuOOviUDocbX	姓名#R#性别#R#出生日期#R#学院#R#手机号码#R#QQ#R#为什么会考虑加入XX社#R#觉得自己加入XX社的优势#R#对于XX社的看法和建议#R#你的姓名#R#QQ#R#自我评价#R#意愿部门
czjZOiXIdnVK	征文名
fHuEydYQuaVo	您的姓名#R#单位/部门/车间名称#R#岗位/职名#R#岗位职级#R#联系电话（手机）
PNOeUHiZRRRO	您的姓名#R#支行/部门名称#R#岗位#R#岗位职级#R#联系电话（手机）
AuzPtbHCEKOl	当选人的姓名#R#当选时间
UwKYMobnahZL	你的手机号码#R#你的身份证号码#R#你的姓名#R#你的网址
fzeILTbiNXIi	姓名#R#性别#R#出生地#R#籍贯#R#身份证号#R#民族#R#政治面貌#R#户口所在地#R#班内学号#R#班级#R#入学年月#R#入学方式#R#就读方式#R#家庭住址#R#QQ号码#R#家庭成员或监护人信息：姓名#R#关系#R#民族#R#工作单位#R#现住址#R#户口所在地#R#家庭成员或监护人的联系电话（手机）#R#是否为监护人#R#联系电话（手机）#R#QQ号码#R#家庭成员或监护人信息：姓名#R#关系
fZDyOfPCJCAS	群昵称#R#群昵称启用时间#R#群昵称变更#R#变更群昵称启用时间#R#性别#R#手机#R#QQ号#R#微信号#R#是否住校#R#出生日期#R#家长姓名#R#家长电话（手机）#R#家庭住址
NiVFWncOsfbL	姓名#R#性别#R#出生日期#R#学院#R#手机号码#R#QQ#R#为什么会考虑加入XX社#R#觉得自己加入XX社的优势#R#对于XX社的看法和建议#R#QQ#R#自我评价#R#意愿部门
DOpXdVdvkGru	问题标题16.3666226035
UZxkIenbhVCn	你的姓名
MFQiqpSQuGjG	你孩子的姓名#R#是否在星期六上午背书#R#是否完成各科作业#R#是否帮忙做家务#R#你孩子周末在家玩游戏吗？#R#你在周末有没有时间去陪陪孩子，关心他的喜怒哀乐？
QlNLeEExSxrB	你的姓名
TfnyWRjPTEkd	姓名#R#在进行高处作业时，登高位置在14m，需要办理哪级登高票？#R#我国实行生产安全事故责任追究制度，事故调查处理坚持“四不放过”原则。“四不放过”原则是指( )。
POZRKoZyqZeY	隔壁老郭
fFlcBJvbQyAM	你的姓名#R#你的手机号码#R#本科毕业学校#R#本科所学专业#R#研究生所在院校#R#研究生所学专业#R#QQ号#R#微信号
LHDDFWNmYmFr	姓名#R#学号#R#学院#R#手机号#R#是否社团内成员
NpYwbZchAheI	家长姓名#R#电话号码
HKiSRpaSXZkp	你的姓名易明芳
InrTRXYpjdSi	你的网址#R#你的网址
KxWJqGoZsQvr	姓名#R#性别#R#性别#R#手机#R#QQ号#R#预计一共带多少同学来呀？（包括你自己）#R#是否参加#R#对这次的活动有没有什么建议：）（吐槽留言区）#R#家长姓名#R#家长电话（手机）#R#家庭住址
MlGajAQIsJAf	你的姓名#R#你的手机号码#R#你总共交了多少钱#R#对自己上课情况说明#R#是否合同发票齐全
dmDLvTJAgRhL	您的姓名#R#公司/团队名称#R#岗位职级#R#岗位职级#R#联系电话（手机）
baeeRqnMpyNk	姓名#R#加粉数量
MPHRATySXPvD	你的姓名#R#你的手机号码
GGcFMQSENVol	你的姓名
SFyTmBdSjuwO	你的姓名#R#你的手机号码#R#学校名
EomOjNSCoZHK	学生姓名
auqxoFTmAMCF	专业班级#R#12.27周四空余时间段#R#30-13#R#20#R#00-18#R#20#R#40-22#R#00#R#12.28周五空余时间段#R#30-13#R#20#R#00-18#R#20#R#40-22#R#00#R#12.29周六空余时间段#R#30-13#R#20#R#00-18#R#20#R#40-22#R#00#R#12.30周日空余时间段#R#30-13#R#20#R#00-18#R#20#R#40-22#R#00#R#12.19周三空余时间段#R#30-13#R#20#R#00-18#R#20#R#40-22#R#00#R#12.20周四空余时间段#R#30-13#R#20#R#00-18#R#20#R#40-22#R#00#R#12.21周五空余时间段#R#30-13#R#20#R#00-18#R#20#R#40-22#R#00#R#12.22周六空余时间段#R#30-13#R#20#R#00-18#R#20#R#40-22#R#00#R#12.23周日空余时间段#R#30-13#R#20#R#00-18#R#20#R#40-22#R#00#R#12.24周一空余时间段#R#30-13#R#20#R#00-18#R#20#R#40-22#R#00#R#12.25周二空余时间段#R#30-13#R#20#R#00-18#R#20#R#40-22#R#00#R#12.26周三空余时间段#R#30-13#R#20#R#00-18#R#20#R#40-22#R#00#R#12.18周二空余时间段#R#30-13#R#20#R#00-18#R#20#R#40-22#R#00#R#学院#R#姓名#R#学号#R#联系方式#R#12.17周一空余时间段#R#30-13#R#20#R#00-18#R#20#R#40-22#R#00
JJdQKqvJZIQE	您觉得《项目I-Forge1.12.2事件翻译》怎么样？#R#您觉得《项目I-Forge1.12.2事件翻译》有什么缺点？#R#您会向其它MC开发者推荐这篇开发性文档吗？
bEbtlBpjeKyq	名称#R#扣扣#R#所属科别#R#本阶段课内完成事务#R#写一遍该课报告#R#其他事务报告#R#报告时间
TnSXZjfHgSzr	日期#R#销售/BD姓名#R#拜访商家名称#R#商家地点#R#隶属公司#R#商家等级#R#KP（关键人）#R#KP联系电话#R#跟进状态#R#未签约原因
RYfCIMawzrTm	您的真名#R#详细描述你的问题1#R#详细描述你的问题2#R#详细描述你的问题3#R#岗位职级#R#岗位职级#R#联系电话（手机）
IJJcfwZokoaT	行社代码#R#行社简称#R#参加人数#R#志愿活动内容
XneOzUakeqvr	你的姓名
SyJCrmMNsoYX	你的网址#R#你的邮箱
TlQIQBtDGIxZ	您的免单产品是#R#定单号#R#免单负责人
MmPPLtqpUefe	姓名#R#专业#R#学号#R#离校日期#R#返校日期#R#目的地#R#联系方式#R#备注#R#你的手机号码#R#你的姓名
OIcqZTmNXQAv	姓名#R#性别#R#出生日期#R#学院#R#手机号码#R#QQ#R#为什么会考虑加入XX社#R#觉得自己加入XX社的优势#R#对于XX社的看法和建议#R#QQ#R#自我评价#R#意愿部门
YXxUdfSZjJaJ	姓名#R#性别#R#出生地#R#籍贯#R#身份证号#R#民族#R#政治面貌#R#户口所在地#R#班内学号#R#班级#R#入学年月#R#入学方式#R#就读方式#R#家庭住址#R#QQ号码#R#家庭成员或监护人信息：姓名#R#关系#R#民族#R#工作单位#R#现住址#R#户口所在地#R#家庭成员或监护人的联系电话（手机）#R#是否为监护人#R#联系电话（手机）#R#QQ号码#R#家庭成员或监护人信息：姓名#R#关系
NaJyaKLlvtLZ	你的网址
ZeoNBlhUBTvl	你最喜欢的3部电影#R#你最喜欢的5种美食#R#你的1个新年愿望#R#你的姓名#R#你的号数
QyNYWziRpbNC	你的姓名#R#水的密度是#R#水的特性
WuaEkUIsAXAY	姓名#R#性别#R#出生日期#R#学院#R#手机号码#R#QQ#R#为什么会考虑加入XX社#R#觉得自己加入XX社的优势#R#对于XX社的看法和建议#R#QQ#R#自我评价#R#意愿部门
ELiLXBQGLnsn	姓名#R#部门#R#手机号码#R#邮箱#R#课程选择#R#岗位#R#方便参加课程时间#R#近期意向学习内容#R#其他建议
KLAHbLivshyW	你的手机号码#R#你的手机号码#R#你的出生年月#R#你的出生年月
TvVXypIptQck	序号#R#姓名#R#教师资格证级别#R#教师资格证号码#R#第一学历#R#最高学历#R#参加工作时间#R#行政职务名称#R#专业技术职务#R#专业技术职务取得时间#R#最高荣誉#R#手机号#R#办公电话#R#电子邮箱
PjmSudUUwKBE	姓名#R#性别#R#出生日期#R#学院#R#手机号码#R#QQ#R#为什么会考虑加入XX社#R#觉得自己加入XX社的优势#R#对于XX社的看法和建议#R#QQ#R#自我评价#R#意愿部门
LNAtqzCpMiro	你的公司/店铺名#R#你的姓名#R#你的手机号码#R#你公司/店铺的主营业务类型#R#你所在城市#R#你的公司/店铺所在社区及门牌号#R#主营业务详细信息说明#R#你的其他联系方式#R#微信号、QQ号等。)#R#公司/店铺所在专业市场或商圈
LLzGDKWaluLz	姓名#R#性别#R#出生地#R#籍贯#R#身份证号#R#民族#R#政治面貌#R#户口所在地#R#班内学号#R#班级#R#入学年月#R#入学方式#R#就读方式#R#家庭住址#R#QQ号码#R#家庭成员或监护人信息：姓名#R#关系#R#民族#R#工作单位#R#现住址#R#户口所在地#R#家庭成员或监护人的联系电话（手机）#R#是否为监护人#R#联系电话（手机）#R#QQ号码#R#家庭成员或监护人信息：姓名#R#关系
TQubvTfmidAw	日期#R#日期#R#销售/BD姓名#R#拜访商家名称#R#商家地点#R#隶属公司#R#商家等级#R#KP（关键人）#R#KP联系电话#R#跟进状态#R#未签约原因
ZsjIdyvTYOLp	问题标题18.4124587692
FDdPYPClzLqw	你的姓名
RWHEYYRQetDz	c服or汉服#R#衣服名称#R#衣服完整度#R#衣服码数#R#衣服状态#R#是否有鞋，鞋子码数#R#衣服店家
XQQgVovxSAgE	#R#性别#R#出生地#R#籍贯#R#身份证号#R#民族#R#政治面貌#R#户口所在地#R#班内学号#R#班级#R#入学年月#R#入学方式#R#就读方式#R#家庭住址#R#QQ号码#R#家庭成员或监护人信息：姓名#R#关系#R#民族#R#工作单位#R#现住址#R#户口所在地#R#家庭成员或监护人的联系电话（手机）#R#是否为监护人#R#联系电话（手机）#R#QQ号码#R#家庭成员或监护人信息：姓名#R#关系
eSzMWwfEaovI	姓名马明昊#R#性别#R#出生地#R#籍贯#R#身份证号#R#民族#R#政治面貌#R#户口所在地#R#班内学号#R#班级#R#入学年月#R#入学方式#R#就读方式#R#家庭住址#R#QQ号码#R#家庭成员或监护人信息：姓名#R#关系#R#民族#R#工作单位#R#现住址#R#户口所在地#R#家庭成员或监护人的联系电话（手机）#R#是否为监护人#R#联系电话（手机）#R#QQ号码#R#家庭成员或监护人信息：姓名#R#关系
PhCteoLeLHTZ	你的姓名？#R#你的性别？#R#技术方向#R#掌握技术栈
DRcUHfTZGCIk	未命名的标题
PDrWMoJNbDOo	日期#R#销售/BD姓名#R#拜访商家名称#R#商家地点#R#隶属公司#R#商家等级#R#KP（关键人）#R#KP联系电话#R#跟进状态#R#未签约原因
JQASoYytmVuv	您的姓名#R#公司/团队名称#R#岗位职级#R#岗位职级#R#联系电话（手机）
KkAHYqThyizf	姓名#R#性别
HaoFemPDIFXA	你的学历
GVqReJiCvMee	姓名#R#性别#R#出生地#R#籍贯#R#身份证号#R#民族#R#政治面貌#R#户口所在地#R#班内学号#R#班级#R#入学年月#R#入学方式#R#就读方式#R#家庭住址#R#QQ号码#R#家庭成员或监护人信息：姓名#R#关系#R#民族#R#工作单位#R#现住址#R#户口所在地#R#家庭成员或监护人的联系电话（手机）#R#是否为监护人#R#联系电话（手机）#R#QQ号码#R#家庭成员或监护人信息：姓名#R#关系
ZjVXDyNJqhNt	孩子学号#R#关注禁毒微信公众平台使用的手机号码
VTTNHPibPvRA	边城读后感
AJEJHqmyVKDF	姓名#R#性别#R#出生地#R#籍贯#R#身份证号#R#民族#R#政治面貌#R#户口所在地#R#班内学号#R#班级#R#入学年月#R#入学方式#R#就读方式#R#家庭住址#R#QQ号码#R#家庭成员或监护人信息：姓名#R#关系#R#民族#R#工作单位#R#现住址#R#户口所在地#R#家庭成员或监护人的联系电话（手机）#R#是否为监护人#R#联系电话（手机）#R#QQ号码#R#家庭成员或监护人信息：姓名#R#关系
FTxTsdkmqiQq	你的姓名#R#你的手机号码#R#你的收货地址
SGLTArmcyjXv	参赛者姓名#R#参赛报名项目#R#参赛选手所在科室
fYpaJBHPVyrY	姓名#R#性别#R#手机#R#QQ号#R#微信号#R#是否住校#R#出生日期#R#身份证号#R#家长姓名#R#家长电话（手机）#R#家庭住址
aLKtZieNlCCA	你的姓名#R#你在那个部门？#R#你认为科协的活动有意义吗
UYpIZjteQgkN	姓名#R#性别#R#出生地#R#籍贯#R#身份证号#R#民族#R#政治面貌#R#户口所在地#R#班内学号#R#班级#R#入学年月#R#入学方式#R#就读方式#R#家庭住址#R#QQ号码#R#家庭成员或监护人信息：姓名#R#关系#R#民族#R#工作单位#R#现住址#R#户口所在地#R#家庭成员或监护人的联系电话（手机）#R#是否为监护人#R#联系电话（手机）#R#QQ号码#R#家庭成员或监护人信息：姓名#R#关系
bwSbwyUHhdqk	宗教活动场所法人：①持有宗教事务部门发放的《宗教活动场所登记证》；或②参考清查底册中“资料来源”为“宗教”的单位。#R#请填写你的县市区和姓名，以“XX县市区，姓名”的格式#R#.律师事务所。领取司法部门发放的《律师事务所执业许可证》的认定为法人单位。#R#现实中的产业活动单位，以分支机构、派出机构、常驻代表机构、常驻办事机构、办事处、联络处、办公室、工厂、车间、仓库、研究中心、销售部、售后服务部等形式存在。#R#现实中的产业活动单位，以分支机构、派出机构、常驻代表机构、常驻办事机构、办事处、联络处、办公室、工厂、车间、仓库、研究中心、销售部、售后服务部等形式存在。#R#依法成立的分支机构，主要通过查看证照和核对清查底册来识别。#R#未经法定程序批准设立的其他产业活动单位，主要通过判断行业范围和地域范围来确定。#R#个体经营户是指生产资料归劳动者个人所有，以个体劳动为基础，劳动成果归劳动者个人占有和支配的一种经营单位。#R#社会经济活动所在地（实际经营地、实际运营地等）与行政登记住所在同一地点的普查对象，归入该地点所在县级区域的普查范围，由所在地普查区、普查小区负责单位清查。#R#关于工会，正确的是#R#乡镇政府和党委，如果分别有单独的“三定方案”，且会计上能够单独核算资产，则分别作为法人单位；否则，作为一个法人单位，单位名称填写为“某某某乡（镇）人民政府（党委）”。这种说法是正确的还是错误的？#R#关于乡镇中小学、乡镇所属的站、所以及村和社区医疗服务等单位的说法正确的是？#R#普查员如何处理许可证与登记注册证照的关系？#R#在城镇、乡村从事建筑业活动的个体劳动者（如：泥瓦工、木工、油漆工、水电工等）需满足哪些条件才能作为建筑业个体经营户？#R#彩票销售网点是否是普查对象#R#社会经济活动所在地（实际经营地、实际运营地等）与行政登记住所不在同一地点的普查对象，归入社会经济活动所在地（实际经营地、实际运营地等）的县级区域的普查范围，#R#，建筑业法人单位归入注册地所在的县级区域的普查范围，由注册地所在的普查区、普查小区负责单位清查。#R#有两处或两处以上社会经济活动所在地（实际经营地、实际运营地等）的普查对象，符合条件的，分别作为法人单位和产业活动单位进行普查，#R#入户实际经营地B，发现该单位为一家咖啡店，调查发现该单位为实际经营地A总店的分店，且符合产业活动单位的条件，确定为产业活动单位。应由实际经营地A和B所在普查小区的普查员分别调查法人单位和分店。#R#入户实际经营地A，调查发现该单位为一家饭店，营业执照显示该单位为法人单位，但登记注册地址在另外一个地点C。应由实际经营地A所在普查小区的普查员调查登记。#R#国有商业银行的省（自治区、直辖市）和市（地、州、盟）分支机构（包含直辖市中的区（县）分支机构），视同法人单位；县（区、市、旗）支行及所属的分理处、储蓄所等营业网点作为产业活动单位。#R#国有商业银行的省（自治区、直辖市）和市（地、州、盟）分支机构（包含直辖市中的区（县）分支机构）作为________；县（区、市、旗）支行及所属的分理处、储蓄所等营业网点作为_____。#R#保险公司垂直管理的省（自治区、直辖市）、市（地、州、盟）保险机构（包含直辖市中的区（县）分支机构）作为______；县（区、市、旗）及以下分支机构作为______。#R#中国邮政集团公司的省（自治区、直辖市）、市（地、州、盟）邮政机构作为_________；县（市、区、旗）及以下分支机构作为_______。#R#隶属于国家烟草专卖局（中国烟草总公司）、中国盐业集团有限公司的市（地、州、盟）及以上烟草、盐业专卖机构作为_______；县及以下分支机构作为________。#R#保险公司垂直管理的省（自治区、直辖市）、市（地、州、盟）保险机构（包含直辖市中的区（县）分支机构）视同法人单位；县（区、市、旗）及以下分支机构作为产业活动单位。#R#电信行业垂直管理单位设立的省（自治区、直辖市）、市（地、州、盟）分支机构（包含直辖市中的区（县）分支机构）视同法人单位,县（市、区、旗）分支机构及营业网点作为产业活动单位。以下说法正确的是#R#中国石油天然气集团有限公司、中国石油天然气股份有限公司、中国石油化工集团公司、中国石油化工股份有限公司、中国海洋石油集团有限公司下属的加油站作为产业活动单位；其他加油站根据证照确定单位类型。#R#中国邮政集团公司的省（自治区、直辖市）、市（地、州、盟）邮政机构视同法人单位；县（市、区、旗）及以下分支机构作为产业活动单位。#R#隶属于国家烟草专卖局（中国烟草总公司）、中国盐业集团有限公司的市（地、州、盟）及以上烟草、盐业专卖机构视同法人单位；县及以下分支机构作为产业活动单位。#R#电力行业垂直管理机构下面说法不正确的是#R#垂直管理机构认定视同法人单位的要点，下面说法不正确的是#R#未领取相关证照、不直接从事经营活动的派出机构（如办事处、联络处、办公室等），不单独作为普查对象。这种说法是否正确？#R#购物中心自营的商品销售或餐饮经营活动，符合产业活动单位条件的，作为产业活动单位，否则不单独作为普查对象。
YqwloJJCOhSF	学习成效好的学员#R#学习成效良的学员#R#学习成效不理想学员
JDVHyBAGKXXo	你的姓名#R#班级
dihlsdbiTdEI	姓名#R#性别#R#出生日期#R#学院#R#手机号码#R#QQ#R#为什么会考虑加入XX社#R#觉得自己加入XX社的优势#R#对于XX社的看法和建议#R#QQ#R#自我评价#R#意愿部门
LLCQorBlNdyb	班级#R#你的姓名#R#电话#R#QQ
ECbrBEpyXref	你的姓名#R#你的性别#R#你的学历
HLeAWoXkNVGN	学号#R#姓名#R#教师序号#R#教师姓名#R#毕业论文研究方向
WsIfFWrJjtDd	你的姓名#R#你的手机号码
XNxTHSILbJry	你的服装尺寸
JviKsAuQdVay	您觉得《项目I-Forge1.12.2开发者事件大全》怎么样？#R#您觉得《项目I-Forge1.12.2开发者事件大全》有什么优缺点？#R#文档中有含混不清的地方吗？#R#您会向其它MC开发者推荐这个开发性文档吗？
etIPFoChwywG	L(不加绒)#R#XL(不加绒)#R#2XL(不加绒)#R#3XL(不加绒)#R#4XL(不加绒)#R#L(加绒)#R#XL(加绒)#R#2XL(加绒)#R#3XL(加绒)#R#4XL(加绒)
bDEpZhLiZusL	我的免单选项#R#谁送我的免单#R#订单编号#R#免单日期#R#订单编号
YUrYuYZJIfvC	你的学号#R#你的姓名#R#最后一门考试时间#R#更倾向于线上培训还是线下培训#R#是否有意向竞选系统负责人？#R#更倾向于线上培训还是线下培训
MGFCpvWLdNkO	姓名#R#正式员工#R#马甲#R#笑脸#R#风衣#R#领带#R#名牌#R#围巾#R#手套#R#西裤
eGIJGQubarrZ	导游姓名#R#接团日期#R#成人
UOcmHXdBfOYc	QQ号#R#软件封号吗？
GSbbpXfkNhwN	姓名#R#学院#R#学号#R#联系方式
QdwQlnhWUeNG	姓名#R#部门#R#手机号码#R#邮箱#R#课程选择#R#岗位#R#方便参加课程时间#R#近期意向学习内容#R#其他建议
YukFRBQTMMjA	姓名#R#开户行（包括支行：如建设银行*****支行）
BWQyoxlVGEeh	你的姓名#R#你的手机号码#R#部门#R#职务#R#QQ
ATFVYFxvvIGE	电脑备份
NgppuJPMaRhh	化合物编号 （403实验室 ） #R#化合物 中文（English）名称 纯度#R#CAS No.#R#品牌#R#规格 #R#数量#R#分子式 Molecular Formula#R#分子量 Formula Weight#R#储存条件#R#储存位置#R#购买日期#R#备注
DBzDYWrgwFXQ	姓名#R#请选择参加的学习课程#R#不能参加的原因
ODNIWYbUprNN	活动名称#R#活动内容#R#活动地点#R#活动时间#R#主办部门#R#负责人#R#负责人联系方式Tel/QQ#R#分管主席和分管老师#R#活动报名方式#R#备注
ENksVENJkUjM	你的姓名#R#你的手机号码
YgRdXlUpMFGW	日期#R#销售/BD姓名#R#拜访商家名称#R#商家地点#R#隶属公司#R#商家等级#R#KP（关键人）#R#KP联系电话#R#跟进状态#R#未签约原因
EKctQENPFILK	姓名#R#部门#R#手机号码#R#邮箱#R#课程选择#R#岗位#R#方便参加课程时间#R#近期意向学习内容#R#其他建议
QseyHnqgNAYq	姓名#R#性别#R#手机#R#QQ号#R#微信号#R#是否住校#R#出生日期#R#家长姓名#R#家长电话（手机）#R#家庭住址
MWJDiCrEVlfP	你的姓名#R#你的手机号码
HlXpoaxZeWpe	姓名#R#性别#R#手机#R#QQ号#R#微信号#R#是否住校#R#出生日期#R#家长姓名#R#家长电话（手机）#R#家庭住址
OXOJAmARveaI	学生姓名#R#是否已交社保
AszKqzwXpnSK	收据编号#R#收据编号#R#工程名称#R#开具事由#R#开具金额#R#领取人员#R#开具日期#R#工程名称#R#开具金额#R#收据编号#R#领取人
KzUZssmnGgOa	你的学历#R#你的学历
fHGhfXQltdZh	姓名#R#性别#R#出生地#R#籍贯#R#身份证号#R#民族#R#政治面貌#R#户口所在地#R#班内学号#R#班级#R#入学年月#R#入学方式#R#就读方式#R#家庭住址#R#QQ号码#R#家庭成员或监护人信息：姓名#R#关系#R#民族#R#工作单位#R#现住址#R#户口所在地#R#家庭成员或监护人的联系电话（手机）#R#是否为监护人#R#联系电话（手机）#R#QQ号码#R#家庭成员或监护人信息：姓名#R#关系
QirfxcZJSAqw	你的姓名
p5c15c32f1d5b74af94042f770102b5ee	姓名#R#性别#R#出生地#R#籍贯#R#身份证号#R#民族#R#政治面貌#R#户口所在地#R#班内学号#R#班级#R#入学年月#R#入学方式#R#就读方式#R#家庭住址#R#QQ号码#R#家庭成员或监护人信息：姓名#R#关系#R#民族#R#工作单位#R#现住址#R#户口所在地#R#家庭成员或监护人的联系电话（手机）#R#是否为监护人#R#联系电话（手机）#R#QQ号码#R#家庭成员或监护人信息：姓名#R#关系
NLkArTumCAbS	家长姓名#R#电话
bLhimPcnqmMh	是否同意物业加入筹备组#R#你的房号？
eNokjGSzjvIX	问题标题10.9386392432#R#问题标题10.9386392432
XpzDANiNzXpu	姓名#R#性别#R#出生地#R#籍贯#R#身份证号#R#民族#R#政治面貌#R#户口所在地#R#班内学号#R#班级#R#入学年月#R#入学方式#R#就读方式#R#家庭住址#R#QQ号码#R#家庭成员或监护人信息：姓名#R#关系#R#民族#R#工作单位#R#现住址#R#户口所在地#R#家庭成员或监护人的联系电话（手机）#R#是否为监护人#R#联系电话（手机）#R#QQ号码#R#家庭成员或监护人信息：姓名#R#关系
IOGstGJOfSlv	你的姓名
QTPBMElLAzme	你的姓名#R#你的手机号码#R#实习企业单位名称#R#离校时间#R#实习企业所在城市
VMhuvUHZzaYI	姓名#R#性别#R#出生地#R#籍贯#R#身份证号#R#民族#R#政治面貌#R#户口所在地#R#班内学号#R#班级#R#入学年月#R#入学方式#R#就读方式#R#家庭住址#R#QQ号码#R#家庭成员或监护人信息：姓名#R#关系#R#民族#R#工作单位#R#现住址#R#户口所在地#R#家庭成员或监护人的联系电话（手机）#R#是否为监护人#R#联系电话（手机）#R#QQ号码#R#家庭成员或监护人信息：姓名#R#关系
FmJQUIVzmcib	你对民间传统工艺有了解吗？了解多少？#R#你知道《我在故宫修文物》吗？#R#童年的小玩意，你还记得多少？#R#你还知道有哪些童年的民间工艺吗？#R# 你愿意看皮影戏还是看复仇者联盟？#R#你觉得民间传统工艺有保护的必要吗？#R#下列选项，你觉得哪些能让民间传统工艺得到有效保护？#R#你觉得作为青少年，我们该如何守护民间传统工艺？#R#你对民间工艺未来的发展怎么看？#R#你认为保护这些民间工艺将对于国家有哪些好处？#R#你还能想到保护民间传统工艺的好处吗？#R#你认为保护这些民间工艺将对于国家有哪些好处？
PWvtMHMeBVmx	学号+实名#R#到课情况
MFRhQVLMtqfp	你的姓名#R#你的手机号码#R#你的性别#R#你的出生年月#R#施工优势项#R#施工优势地区#R#施工业绩名称#R#愿意承接的项目造价#R#行业执业证件#R#行业从业年限#R#微信或QQ#R#学历
fiTynlPUtWdg	你的姓名#R#你的性别#R#身高#R#体重#R#腰围#R#裤长#R#上衣尺码
QLjPfvUUXKJU	姓名#R#性别女#R#出生地#R#籍贯#R#身份证号#R#民族#R#政治面貌#R#户口所在地#R#班内学号#R#班级#R#入学年月#R#入学方式#R#就读方式#R#家庭住址#R#QQ号码#R#家庭成员或监护人信息：姓名#R#关系#R#民族#R#工作单位#R#现住址#R#户口所在地#R#家庭成员或监护人的联系电话（手机）#R#是否为监护人#R#联系电话（手机）#R#QQ号码#R#家庭成员或监护人信息：姓名#R#关系
EsolXeHsDMxp	你的姓名#R#品名#R#你的服装尺寸
YOceGVVDddnn	你的姓名#R#你的手机号码#R#你的性别
MEAtScVbeSgb	时间
ehiTpXPVeoRS	你的ID#R#你的QQ#R#发生时间#R#举报对象#R#请选择举报类型#R#若上一题选择其他，请您输入具体类型#R#具体内容#R#您可发送具体证据至2219246604@qq.com#R#玩家举报+您的QQ)#R#请您再次确认信息准确无误
MYDFfVXJMsBi	主题清晰度（100分满分）#R#声音洪亮度（100分满分）#R#表达自信度（100分满分）#R#演讲形象（100满分）（站姿、眼神）#R#互动性（100分满分）（眼神互动、邀请听众回答）#R#演讲的吸引力（100分满分）
AAKSzhgimpcQ	日期#R#销售/BD姓名#R#拜访商家名称#R#商家地点#R#隶属公司#R#商家等级#R#KP（关键人）#R#KP联系电话#R#跟进状态#R#未签约原因
CEsydLIDOMQm	姓名#R#性别#R#手机#R#QQ号#R#微信号#R#OA邮箱#R#身份证号码#R#家长姓名#R#家长电话（手机）#R#家庭住址
KicArfOFaXyq	姓名#R#部门#R#手机号码#R#邮箱#R#课程选择#R#岗位#R#方便参加课程时间#R#近期意向学习内容#R#其他建议
PpplXSgFKQii	学号+实名#R#到课情况
WQxkskjoqJxj	姓名 单浩凯#R#性别#R#出生日期#R#学院#R#手机号码#R#QQ#R#为什么会考虑加入XX社#R#觉得自己加入XX社的优势#R#对于XX社的看法和建议#R#QQ#R#自我评价#R#意愿部门
UgxpnzYkIQwl	姓名#R#我们获得几次国家级荣誉？我们接待过几位中央政治局常委？#R#董事长对当下时代的定义#R#我们要做商业模式、产品、 的变革#R#事业三句话？#R#商业模式有哪三个要素？#R#我们的事业模式？#R#我们的产品模式？#R#组织管理模式包含什么？#R#衡量变革有效性的指标#R#利润实现的关键是？#R#人均劳效的三大抓手#R#企业2022年目标#R#2019年目标#R#人均劳效的目标是？（2022年，每年）#R#怎么理解“只有英雄才会召唤英雄， 唤起心中的英雄”#R#怎么理解“此一时，彼一时”#R#怎么理解“只有开对门，悟性才有用，学习才有用，智慧才会爆发”#R#对于公司，我们现在的门是什么？#R#“有效”解决做什么,\"效率“解决什么？董事长解决做什么的问题，部门解决怎么做。 #R#新浙商精神？#R#简述“复利思维”#R#未命名的标题#R#民族#R#工作单位#R#现住址#R#户口所在地#R#家庭成员或监护人的联系电话（手机）#R#是否为监护人#R#团队领导人最重要的能力，就是让你的团队始终有这三个点， 。但是这三个点都是基于开对门的#R#QQ号码#R#家庭成员或监护人信息：姓名#R#关系
GeRlnaNwoLRS	你的姓名#R#你的手机号码
BONCqCAJoKpp	你的姓名#R#你的手机号码#R#你的出生年月#R#职称任命时间#R#职称#R#职称#R#来院时间#R#你的邮箱#R#你的网址
KyemduUJWFJP	你的姓名
YDpCFAonErBw	姓名#R#手机#R#工作单位#R#家庭地址#R#业务介绍
KZNpgyXufLei	姓名#R#学号#R#目前的TD数#R#参与跑酷社训练次数
ZscKjcQZswIK	商品#R#商品大类#R#特仑苏属于奶类。)#R#你的姓名#R#进价#R#你的姓名#R#零售价#R#你的出生年月
AkHaPjyatIRe	你的姓名#R#你的手机号码#R#你的身份证号码
JhdTFCafxJQw	你的姓名CC
BQqpMMkQyjkI	姓名#R#性别#R#出生日期#R#学院#R#手机号码#R#QQ#R#为什么会考虑加入XX社#R#觉得自己加入XX社的优势#R#对于XX社的看法和建议#R#QQ#R#自我评价#R#意愿部门
JbNFlpoZMlCk	姓名#R#性别#R#手机#R#QQ号#R#微信号#R#是否住校#R#出生日期#R#家长姓名#R#家长电话（手机）#R#家庭住址
cuqArRsNXJWR	社团名称#R#性别#R#出生日期#R#学院#R#社长或活动负责人手机号码#R#摊位预订活动#R#是否需要向学校申请什么需要#R#如果需要申请，请详细说明#R#QQ#R#预订活动摊位地点#R#觉得自己加入XX社的优势#R#社长名称或活动负责人名称#R#对于XX社的看法和建议#R#QQ#R#社长QQ或活动负责人QQ#R#意愿部门
PJwlIvRNIzop	姓名#R#性别#R#出生日期#R#学院#R#手机号码#R#QQ#R#为什么会考虑加入XX社#R#觉得自己加入XX社的优势#R#对于XX社的看法和建议#R#QQ#R#自我评价#R#意愿部门
GoFoWWIGtbXD	订单品类#R#订单编号#R# 备注
HDqcpxhpuvAc	日期#R#销售/BD姓名#R#拜访商家名称#R#商家地点#R#隶属公司#R#商家等级#R#KP（关键人）#R#KP联系电话#R#跟进状态#R#未签约原因
KPqlKrLPJSph	你的学历#R#你的性别#R#你的出生年月#R#你的出生年月#R#你的性别#R#你的服装尺寸#R#你的出生年月#R#你的服装尺寸#R#你的服装尺寸#R#你的服装尺寸
dEgvjVAfcRdu	您的姓名#R#公司/团队名称#R#岗位职级#R#岗位职级#R#联系电话（手机）
KMyWlxkgLXab	你对于目前的工作状态满意吗#R#你认为不满意最大的来源在哪里#R#你认为你目前最需要的是什么培训#R#目前所在组的培训周期如何#R#你所在组的培训方式为#R#关于有更好的培训效果你的建议是#R#你对于公司或是事业部2019年的建议和期许是
RWWFANeBVppA	姓名#R#性别#R#出生日期#R#QQ#R#手机号码#R#QQ#R#初次成为管理/正式社员年代#R#曾任职就业位置#R#籍贯#R#现任职就业位置#R#QQ#R#自我评价#R#意愿部门
SVcXttbhbqll	csy#R#性别#R#手机#R#QQ号#R#微信号#R#是否住校#R#出生日期#R#家长姓名#R#家长电话（手机）#R#家庭住址
TMscOnxJvnCm	你的姓名#R#你的手机号码#R#你的性别#R#你的学历
ZnLnvVTVSzix	姓名#R#性别#R#电话#R#邮箱#R#城市#R#单位#R#是否住校#R#出生日期#R#家长姓名#R#家长电话（手机）#R#家庭住址
RLCAWxkEDegF	学生姓名
LCxkAPsTLEKJ	日期#R#销售/BD姓名#R#拜访商家名称#R#商家地点#R#隶属公司#R#商家等级#R#KP（关键人）#R#KP联系电话#R#跟进状态#R#未签约原因
aIlIcTeWvNKM	日期#R#销售/BD姓名#R#拜访商家名称#R#商家地点#R#隶属公司#R#商家等级#R#KP（关键人）#R#KP联系电话#R#跟进状态#R#未签约原因
GQlEqPyygQaA	你的性别#R#你的性别#R#杨敏#R#你的手机号码#R#你的邮箱#R#你的性别
PAgyUerscUPC	你的姓名
WiouaYVruvQz	姓名#R#性别#R#出生地#R#籍贯#R#身份证号#R#民族#R#政治面貌#R#户口所在地#R#班内学号#R#班级#R#入学年月#R#入学方式#R#就读方式#R#家庭住址#R#QQ号码#R#家庭成员或监护人信息：姓名#R#关系#R#民族#R#工作单位#R#现住址#R#户口所在地#R#家庭成员或监护人的联系电话（手机）#R#是否为监护人#R#联系电话（手机）#R#QQ号码#R#家庭成员或监护人信息：姓名#R#关系
KfjRDFIyvWyD	姓名#R#性别#R#手机#R#QQ号#R#微信号#R#是否住校#R#出生日期#R#家长姓名#R#家长电话（手机）#R#家庭住址
DaxnLVojPzLR	投票测试
XMtyXbGBQCph	姓名车美佳#R#性别#R#手机18393351283#R#QQ号#R#微信号#R#是否住校#R#出生日期19940430#R#家长姓名#R#家长电话（手机）#R#家庭住址
MbcMRUjUqvmE	您的姓名#R#文科题数#R#理科题数
HGiuFqXAOUzs	姓名#R#性别#R#出生日期#R#分院#R#姓名#R#学号#R#是否为数学建模协会成员#R#班级#R#手机号码#R#QQ#R#为什么会考虑加入XX社#R#觉得自己加入XX社的优势#R#对于XX社的看法和建议#R#QQ#R#自我评价#R#意愿部门
XZurZbfCrGAU	支部名称（代号）#R#姓名#R#积极分子材料有误问题#R#预备党员材料是否有问题#R#入党志愿书是否有问题#R#其他
XAvigJcFwMal	姓名#R#性别#R#任意选择
NnIdJCAfkQWS	您的姓名#R#公司/团队名称#R#岗位职级#R#岗位职级#R#f f f f#R#联系电话（手机）
CLMBLdqehTtU	你的邮箱#R#你的邮箱#R#你的网址#R#你的性别#R#你的出生年月#R#你的服装尺寸#R#你的学历#R#你的姓名#R#你的手机号码#R#你的身份证号码#R#你的学历
NGbUHbTZaeno	教师姓名#R#学校#R#性别#R#所带年级#R#电话号码
AdLRwNhpOkkE	姓名#R#部门#R#手机号码#R#学号#R#课程选择#R#岗位#R#方便参加课程时间#R#近期意向学习内容#R#其他建议
IvtvOalbmaVV	你的姓名#R#你的手机号码#R#你的身份证号码
EPOoGDeGinDX	住宿标准#R#通讯地址#R#邮箱#R#身份证号码#R#科室#R#医院#R#大区#R#地区#R#姓名#R#课程选择#R#岗位#R#方便参加课程时间#R#近期意向学习内容#R#其他建议
WdaOGYvsJsEN	姓名#R#性别#R#出生地#R#籍贯#R#身份证号#R#民族#R#政治面貌#R#户口所在地#R#班内学号#R#班级#R#入学年月#R#入学方式#R#就读方式#R#家庭住址#R#QQ号码#R#家庭成员或监护人信息：姓名#R#关系#R#民族#R#工作单位#R#现住址#R#户口所在地#R#家庭成员或监护人的联系电话（手机）#R#是否为监护人#R#联系电话（手机）#R#QQ号码#R#家庭成员或监护人信息：姓名#R#关系
CTkhuHnEznWk	你的姓名#R#你的手机号码#R#您的户号#R#拒绝交房原因
WqcPcycsmuNs	姓名#R#性别#R#出生日期#R#学院#R#手机号码#R#QQ#R#为什么会考虑加入XX社#R#觉得自己加入XX社的优势#R#对于XX社的看法和建议#R#QQ#R#自我评价#R#意愿部门
JOQMIuzsvMZZ	日期#R#销售/BD姓名#R#拜访商家名称#R#商家地点#R#隶属公司#R#商家等级#R#KP（关键人）#R#KP联系电话#R#跟进状态#R#未签约原因
LQbYdTsjXBSl	你的网址
AMMJylBDpvpv	你的姓名：施铭鑫
bUdPncQCcfUt	平台差评收集表#R#差评事件#R#门店#R#大概问题#R#门店处理人#R#处理结果#R#新零售协调人
OuKEFFYwKVzE	姓名#R#性别#R#出生地#R#籍贯#R#身份证号#R#民族#R#政治面貌#R#户口所在地#R#班内学号#R#班级#R#入学年月#R#入学方式#R#就读方式#R#家庭住址#R#QQ号码#R#家庭成员或监护人信息：姓名#R#关系#R#民族#R#工作单位#R#现住址#R#户口所在地#R#家庭成员或监护人的联系电话（手机）#R#是否为监护人#R#联系电话（手机）#R#QQ号码#R#家庭成员或监护人信息：姓名#R#关系
DizFcVrFmgID	姓名#R#性别#R#出生地#R#籍贯#R#身份证号#R#民族#R#政治面貌#R#户口所在地#R#班内学号#R#班级#R#入学年月#R#入学方式#R#就读方式#R#家庭住址#R#QQ号码#R#家庭成员或监护人信息：姓名#R#关系#R#民族#R#工作单位#R#现住址#R#户口所在地#R#家庭成员或监护人的联系电话（手机）#R#是否为监护人#R#联系电话（手机）#R#QQ号码#R#家庭成员或监护人信息：姓名#R#关系
DhvyMFNfbYCc	微信昵称#R#谁给你的免单#R#所拍免单品类#R#订单编号#R#微信昵称
btnFZMRXrTNf	请填写发票信息
EXgEDvGjjXoU	姓名#R#性别#R#出生地#R#籍贯#R#身份证号#R#民族#R#政治面貌#R#户口所在地#R#班内学号#R#班级#R#入学年月#R#入学方式#R#就读方式#R#家庭住址#R#QQ号码#R#家庭成员或监护人信息：姓名#R#关系#R#民族#R#工作单位#R#现住址#R#户口所在地#R#家庭成员或监护人的联系电话（手机）#R#是否为监护人#R#联系电话（手机）#R#QQ号码#R#家庭成员或监护人信息：姓名#R#关系
BCmiqRQaPDyp	你的姓名#R#你的身份证号码#R#你的邮箱#R#你的手机号码#R#你的性别#R#你的出生年月
WPVakHngNtzz	姓名#R#性别#R#手机#R#QQ号#R#QQ密码#R#是否住校#R#出生日期#R#家长姓名#R#家长电话（手机）#R#家庭住址
GsCVaDXNdZYp	订单品类#R#订单编号#R#备注说明
UWgjiCXuXuSv	你的姓名#R#你的号数#R#你的新年愿望是什么？#R#你喜欢的5种美食#R#你喜欢看的2部电影#R#你喜欢玩的2种游戏
JZhhmNtQLbsK	姓名#R#性别#R#手机#R#QQ号#R#微信号#R#是否住校#R#出生日期#R#家长姓名#R#家长电话（手机）#R#家庭住址
RvxokWisFdIO	车位主姓名#R#车位主身份证号码#R#你的手机号码#R#车位号#R#车位价格#R#合同到期时间#R#你的服装尺寸#R#车位合同到期
eKoZmgEvUKAp	税务申报
FJeHBZgCxBXh	学校名称#R#学籍数
KrEabfsjhmgg	下單日期#R#销售/BD姓名#R#客戶名稱#R#送貨地点#R#備註資料(客戶單號等等資料）#R#商家等级#R#訂購產品及數量#R#KP联系电话#R#跟进状态#R#未签约原因
bCsGzWdVlfLk	你的手机号码13692189621
OBhdurpuXGEe	你的姓名#R#目前码图成绩#R#目前实验报告完成情况#R#自己是否可以独立完成（不用来帮忙，有什么问题我会问的）？#R#如果需要帮助的话，最希望以什么样的方式来呈现？#R#如果开展这次小活动（C语言帮帮忙），你感觉对你的帮助大不大？
BiKnipDGTSfU	姓名#R#性别#R#出生日期#R#学院#R#手机号码#R#QQ#R#为什么会考虑加入XX社#R#觉得自己加入XX社的优势#R#对于XX社的看法和建议#R#QQ#R#自我评价#R#意愿部门
agweHsUBZSFf	你的姓名
GszvjFvhezak	场地费金额
RIsqmCcWGeiN	你的ID#R#性别#R#出生日期#R#学院#R#手机号码#R#QQ#R#为什么会考虑加入XX社#R#觉得自己加入XX社的优势#R#你的QQ#R#QQ#R#自我评价#R#意愿部门
aSrsLFVdOfcm	最新党章修正案是2017年（ ）通过的。#R#新党章是党的（ ）通过的。#R# 新党章共11章( )条。#R#中国共产党是中国工人阶级的先锋队，同时是( )的先锋队，是中国特色社会主义事业的领导核心，代表中国先进生产力的发展要求，代表中国先进文化的前进方向，代表中国最广大人民的根本利益。#R#　中国共产党以马克思列宁主义、毛泽东思想、邓小平理论、“三个代表”重要思想、科学发展观和( )作为自己的行动指南。#R#全党全国各族人民要紧密团结在党中央周围，高举中国特色社会主义伟大旗帜，锐意进取，埋头苦干，为实现推进现代化建设、完成祖国统一、维护世界和平与促进共同发展三大历史任务，为___继续奋斗!#R#引导应对气候变化国际合作，成为全球生态文明建设的重要____、____、____。#R#青年兴则国家兴，青年强则国家强。青年一代____、____、____，国家就有前途，民族就有希望。#R#中国共产党的行动指南是什么？#R#党的十九大的主题是？#R#姓名#R#部门
KUBWxQMzahyL	姓名#R#性别#R#手机#R#QQ号#R#微信号#R#是否住校#R#出生日期#R#家长姓名#R#家长电话（手机）#R#家庭住址
IxsXNlnhBeOi	姓名#R#班级#R#性别#R#申请入党时间#R#被列为入党积极分子时间#R#党课结业时间#R#预备党员发展时间#R#预备党员转正时间#R#培养联系人#R#XXX、XXX 例如#R#梅志强、冯晨晨(注#R#一个教师党员，一个学生党员))#R#入党介绍人#R#XXX、XXX 例如#R#梅志强、冯晨晨(注#R#一个教师党员，一个学生党员))#R#考察人#R#XXX、XXX 例如#R#梅志强、冯晨晨(注#R#一个教师党员，一个学生党员))
SkyGuBdKaiWB	你的姓名#R#入党时所在支部：#R#转正时所在支部：#R#进入现党支部日期：#R#姓名
IwfpuAeeCzbq	姓名#R#性别#R#出生地#R#籍贯#R#身份证号#R#民族#R#政治面貌#R#户口所在地#R#班内学号#R#班级#R#入学年月#R#入学方式#R#就读方式#R#家庭住址#R#QQ号码#R#家庭成员或监护人信息：姓名#R#关系#R#民族#R#工作单位#R#现住址#R#户口所在地#R#家庭成员或监护人的联系电话（手机）#R#是否为监护人#R#联系电话（手机）#R#QQ号码#R#家庭成员或监护人信息：姓名#R#关系
YMlBUAODUFED	你的姓名#R#你的姓名（下拉框选择）
DsbAxXOAvUWf	队员1 学院#R#队员1 班级#R#队员1 姓名#R#队员1 学号#R#队员1 电话号码#R#队员1 QQ#R#队员1 民生银行卡卡号#R#队员1 备注#R#队员2 学院#R#队员2 班级#R#队员2 姓名#R#队员2 学号#R#队员2 手机号码#R#队员2 QQ#R#队员2 民生银行卡卡号#R#队员2 备注
WgadnkHTFQkF	您的姓名#R#公司/团队名称#R#岗位职级#R#岗位职级#R#联系电话（手机）
TWfMUtpvHAEd	圈名#R#部门#R#手机号码#R#邮箱#R#课程选择#R#岗位#R#方便参加课程时间#R#近期意向学习内容#R#其他建议
MNxqfjdUEvBd	姓名#R#部门#R#手机号码#R#邮箱#R#课程选择#R#岗位#R#方便参加课程时间#R#近期意向学习内容#R#其他建议
LnFKeamtOuoJ	测试
HJEYDNIXxcrE	你的姓名张小华#R#你的姓名张小华
eNRvKihNXDvc	姓名#R#性别#R#出生地#R#籍贯#R#身份证号#R#民族#R#政治面貌#R#户口所在地#R#班内学号#R#班级#R#入学年月#R#入学方式#R#就读方式#R#家庭住址#R#QQ号码#R#家庭成员或监护人信息：姓名#R#关系#R#民族#R#工作单位#R#现住址#R#户口所在地#R#家庭成员或监护人的联系电话（手机）#R#是否为监护人#R#联系电话（手机）#R#QQ号码#R#家庭成员或监护人信息：姓名#R#关系
BMLouctfqXgy	你的姓名
FIzWdNAXijrt	你的姓名#R#你的手机号码
VzjReChYJmub	姓名#R#性别#R#出生地#R#籍贯#R#身份证号#R#民族#R#政治面貌#R#户口所在地#R#班内学号#R#班级#R#入学年月#R#入学方式#R#就读方式#R#家庭住址#R#QQ号码#R#家庭成员或监护人信息：姓名#R#关系#R#民族#R#工作单位#R#现住址#R#户口所在地#R#家庭成员或监护人的联系电话（手机）#R#是否为监护人#R#联系电话（手机）#R#QQ号码#R#家庭成员或监护人信息：姓名#R#关系
YpRnDHUsPwBK	你的姓名#R#你的手机号码
SxyqcFThMals	你的姓名
EIxvDjKpkPRX	你的姓名#R#你的手机号码#R#你的身份证号码
SxaIwLCLEgtL	皖事通#R#。。。
RGWbGmdpsFdM	问题标题12.3233908364
TnSquXUFOMRd	姓名#R#性别#R#出生日期#R#学院#R#手机号码#R#QQ#R#为什么会考虑加入XX社#R#觉得自己加入XX社的优势#R#对于XX社的看法和建议#R#QQ#R#自我评价#R#意愿部门
choOwtAEJJAE	姓名#R#加班日期#R#加班时长（小时）#R#加班内容
drmGBAxgrrRd	你的姓名
URPCtlOYOFCV	姓名#R#性别#R#出生地#R#籍贯#R#身份证号#R#民族#R#政治面貌#R#户口所在地#R#班内学号#R#班级#R#入学年月#R#入学方式#R#就读方式#R#家庭住址#R#QQ号码#R#家庭成员或监护人信息：姓名#R#关系#R#民族#R#工作单位#R#现住址#R#户口所在地#R#家庭成员或监护人的联系电话（手机）#R#是否为监护人#R#联系电话（手机）#R#QQ号码#R#家庭成员或监护人信息：姓名#R#关系
JXAEeeIXfOxU	你的性别#R#您来自哪里#R#您多久观看一次花鼓戏
GjYzOfYECLfm	姓名#R#性别#R#出生日期#R#介绍自己#R#未命名的标题#R#QQ#R#为什么会考虑加入XX社#R#未命名的标题#R#对于XX社的看法和建议#R#QQ#R#自我评价#R#意愿部门
eCwzxPHXfmsl	你的姓名
VMpJJtjuLUwi	部门#R#扣分理由：#R#注意个人形象问题，上班时间穿着大方得体，禁止穿拖鞋。#R#扣分理由：#R#扣分理由：#R#商品货物、办公用品、宣传用品等摆放整齐有序、干净，不得杂乱无章。#R#扣分理由：#R#办公桌上办公用品、资料文具等摆放整齐有序、干净，不得杂乱无章。#R#扣分理由：#R#店面及门口地面不得有明显的生活垃圾。#R#扣分理由：#R#厂区地面不得有明显的生活、生产垃圾。#R#办公室地面不得明显的污渍垃圾。#R#部门
dzGbBnepIjKt	你的姓名#R#你的手机号码#R#你的身份证号码#R#你的邮箱#R#你的网址#R#你的性别#R#你的出生年月#R#你的服装尺寸#R#你的学历
abNpLKQJRbKk	您的姓名#R#公司/团队名称#R#岗位职级#R#岗位职级#R#联系电话（手机）
EqZZwJmopVOp	你的姓名#R#入住#R#离店#R#房间号#R#已支付金额#R#开票信息#R#邮寄地址
FJtPOwKTpLew	优点
NrllZBewdFXB	您的姓名#R#公司/团队名称#R#岗位职级#R#岗位职级#R#联系电话（手机）
ThzOFoyoCLDX	姓名#R#性别#R#手机#R#QQ号#R#微信号#R#是否住校#R#出生日期#R#家长姓名#R#家长电话（手机）#R#家庭住址
MajRtghrhSOE	你的姓名#R#你的手机号码
EdmMhAXnylzh	你的寝室号是#R#你们寝室是想要什么类型的报纸#R#你们一个寝室内需要几份？
eRVCijmMXEVt	姓名#R#性别#R#手机#R#QQ号#R#微信号#R#是否住校#R#出生日期#R#家长姓名#R#家长电话（手机）#R#家庭住址
MQWhcietoHTG	股票代码#R#买入价格#R#买入依据#R#目标位#R#卖出依据#R#经验总结
LwnYOyOmZZaK	姓名#R#性别#R#出生地#R#籍贯#R#身份证号#R#民族#R#政治面貌#R#户口所在地#R#班内学号#R#班级#R#入学年月#R#入学方式#R#就读方式#R#家庭住址#R#QQ号码#R#家庭成员或监护人信息：姓名#R#关系#R#民族#R#工作单位#R#现住址#R#户口所在地#R#家庭成员或监护人的联系电话（手机）#R#是否为监护人#R#联系电话（手机）#R#QQ号码#R#家庭成员或监护人信息：姓名#R#关系
PZAlpTYBsMUG	123
HrFUPLWwABIQ	你的学历#R#姓名#R#手机号码#R#性别#R#出生年月#R#爱好、特长#R#自荐理由#R#现考核部门#R#现所在其他考核组织#R#院学生会、系团总支、协会、小分队等)#R#加群#R#药学系学生会主席Tuan考核群697298595#R#加群#R#药学系学生会主席Tuan考核群群聊号码#R#697298595#R#班级#R#药本181班、药学181班)#R#你的学历
WbEkKSfnfZGS	你的姓名
dICbDpvjZTQH	你的姓名#R#你的姓名
NyItCkjdDdNL	姓名#R#性别#R#出生日期#R#学校#R#手机号码#R#QQ#R#为什么会考虑加入XX社#R#觉得自己加入XX社的优势#R#其他(备注)#R#QQ#R#自我评价#R#意愿部门
aWfOHdHISyIq	姓名#R#性别#R#手机#R#QQ号#R#微信号#R#是否住校#R#出生日期#R#家长姓名#R#家长电话（手机）#R#家庭住址#R#身份证号码
UACfJXJtgUTR	姓名#R#性别#R#出生日期#R#学院#R#手机号码#R#QQ#R#为什么会考虑加入XX社#R#觉得自己加入XX社的优势#R#对于XX社的看法和建议#R#QQ#R#自我评价#R#意愿部门
QkOCphqiACQo	姓名#R#性别#R#出生日期#R#学院#R#手机号码#R#QQ#R#为什么会考虑加入XX社#R#觉得自己加入XX社的优势#R#对于XX社的看法和建议#R#QQ#R#自我评价#R#意愿部门
ZkpJoDWTiwHN	问题标题16.6081744478
CgidznUMHWCk	姓名#R#性别#R#出生地#R#籍贯#R#身份证号#R#民族#R#政治面貌#R#户口所在地#R#班内学号#R#班级#R#入学年月#R#入学方式#R#就读方式#R#家庭住址#R#QQ号码#R#家庭成员或监护人信息：姓名#R#关系#R#民族#R#工作单位#R#现住址#R#户口所在地#R#家庭成员或监护人的联系电话（手机）#R#是否为监护人#R#联系电话（手机）#R#QQ号码#R#家庭成员或监护人信息：姓名#R#关系
ebroLkpoQxlh	你的游戏ID职业#R#所需求装备
ehdIKtGmjPjn	你的姓名
TbrpjByhRlLd	车号/车厢号#R#线路名称
WbDtLogDjeUN	姓名#R#性别#R#手机#R#QQ号#R#微信号#R#是否住校#R#出生日期#R#家长姓名#R#家长电话（手机）#R#家庭住址
IvnLMudSmxEh	CG就能看
LzoTUFueuIDp	姓名#R#学号#R#团员文章的 题目
YWofxqBXVLLu	高满意度客户#R#一般满意度客户#R#低满意度客户
cWASTaWRmFEl	choose 10 synonyms of \"abstruse\"#R#choose 10 synonyms of \"altercation\"#R#choose 10 synonyms of \"assuage\"#R#choose 10 synonyms of \"affinity\"#R#choose 10 synonyms of \"castigate\"
CIILkwLUfHzJ	你的姓名
YswWklaOUQMz	姓名#R#联系电话#R#您的订购数量
AIrzPiieYrcI	推荐人#R#姓名#R#品类#R#出生日期#R#订单号#R#手机号码#R#QQ#R#为什么会考虑加入XX社#R#觉得自己加入XX社的优势#R#对于XX社的看法和建议#R#QQ#R#自我评价#R#意愿部门
OKFlNvuzRjPM	姓名#R#性别#R#学号#R#籍贯#R#身份证号#R#民族#R#政治面貌#R#户口所在地#R#联系手机号（1）#R#联系手机号（2）#R#QQ号#R#邮箱#R#入团年月#R#家庭住址#R#监护人联系电话#R#家庭成员或监护人信息：姓名#R#入团单位#R#关系#R#民族#R#工作单位#R#现住址#R#户口所在地#R#家庭成员或监护人的联系电话（手机）#R#是否为监护人#R#入团单位#R#QQ号码#R#家庭成员或监护人信息：姓名#R#关系
LqhUcSzPTmOH	你的手机号码
DJYEgjvCtAzA	姓名#R#性别#R#出生地#R#籍贯#R#身份证号#R#民族#R#政治面貌#R#户口所在地#R#班内学号#R#班级#R#入学年月#R#入学方式#R#就读方式#R#家庭住址#R#QQ号码#R#家庭成员或监护人信息：姓名#R#关系#R#民族#R#工作单位#R#现住址#R#户口所在地#R#家庭成员或监护人的联系电话（手机）#R#是否为监护人#R#联系电话（手机）#R#QQ号码#R#家庭成员或监护人信息：姓名#R#关系
WwaFUkOafsDr	姓名#R#性别#R#出生地#R#籍贯#R#身份证号#R#民族#R#政治面貌#R#户口所在地#R#班内学号#R#班级#R#入学年月#R#入学方式#R#就读方式#R#家庭住址#R#QQ号码#R#家庭成员或监护人信息：姓名#R#关系#R#民族#R#工作单位#R#现住址#R#户口所在地#R#家庭成员或监护人的联系电话（手机）#R#是否为监护人#R#联系电话（手机）#R#QQ号码#R#家庭成员或监护人信息：姓名#R#关系
TTktvsIvhYkz	姓名 
RZOvleugSlaW	7575#R#ilil
DwmnAMwQPzvH	你的姓名#R#你的手机号码
KlmwYFpETarP	姓名#R#性别#R#所在地#R#籍贯#R#身份证号#R#民族#R#政治面貌#R#户口所在地#R#班内学号#R#班级#R#入学年月#R#入学方式#R#就读方式#R#家庭住址#R#QQ号码#R#家庭成员或监护人信息：姓名#R#关系#R#民族#R#工作单位#R#现住址#R#户口所在地#R#家庭成员或监护人的联系电话（手机）#R#是否为监护人#R#联系电话（手机）#R#QQ号码#R#家庭成员或监护人信息：姓名#R#关系
DRqwPovsilSJ	你的姓名#R#你的手机号码#R#你的身份证号码#R#你的网址
LnroTGdxOBLV	姓名#R#性别#R#出生日期#R#学院#R#手机号码#R#QQ#R#为什么会考虑加入XX社#R#觉得自己加入XX社的优势#R#对于XX社的看法和建议#R#QQ#R#自我评价#R#意愿部门
AIaXVKfCyDJR	你的姓名#R#比赛名称#R#获奖情况#R#比赛等级
AHrtjtWULCYc	你的姓名#R#你的手机号码#R#你的身份证号码#R#你的邮箱#R#你的学历
RuoSBSKEQhFZ	你的性别#R#你的出生年月#R#你的服装尺寸#R#当你与父母外出时，遇到行乞的人，你会选择怎么做?#R#你的家庭中有暴力倾向吗?#R#你认为父母应该如何去教育孩子?#R#和邻居见面时你会主动打招呼吗#R#你的学历是#R#你和你父母的关系如何?#R#你每年都会记得自己父母的生日吗#R#你认为你的父母对你严厉吗#R#当你看到一个老人摔倒时你的态度是#R#最看重的家庭美德是哪一种?#R#你的学历#R#你的学历
BKpTuyqZULEz	姓名#R#性别#R#出生地#R#籍贯#R#身份证号#R#民族#R#政治面貌#R#户口所在地#R#班内学号#R#班级#R#入学年月#R#入学方式#R#就读方式#R#家庭住址#R#QQ号码#R#家庭成员或监护人信息：姓名#R#关系#R#民族#R#民族#R#民族#R#工作单位#R#现住址#R#户口所在地#R#家庭成员或监护人的联系电话（手机）#R#是否为监护人#R#联系电话（手机）#R#QQ号码#R#家庭成员或监护人信息：姓名#R#关系
KULlJPcTMZGE	姓名#R#性别#R#出生地#R#籍贯#R#身份证号#R#民族#R#政治面貌#R#户口所在地#R#班内学号#R#班级#R#入学年月#R#入学方式#R#就读方式#R#家庭住址#R#QQ号码#R#家庭成员或监护人信息：姓名#R#关系#R#民族#R#工作单位#R#现住址#R#户口所在地#R#家庭成员或监护人的联系电话（手机）#R#是否为监护人#R#联系电话（手机）#R#QQ号码#R#家庭成员或监护人信息：姓名#R#关系
FtIBQfifrWJw	你的姓名
DNYBCHrBtBLf	你的姓名#R#你的手机号码#R#你的邮箱#R#你的性别#R#政治面貌#R#专业班级#R#年级#R#学号
AmShrgaGkLjk	T1（军刀）#R#姓名#R#分辨率测试样品（B02）#R#分辨率测试样品B03#R#透明胶带#R#声级计#R#温湿度传感器#R#万用表#R#螺丝刀小一字#R#螺丝刀大一字#R#螺丝刀大十字#R#内六角扳手一套#R#dp转vga线#R#插排5米#R#hdmi转vga#R#vga线缆#R#网线2米#R#网线10米#R#钥匙（钥匙开关，中控，环控，主机）#R#绝缘胶布#R#网线测试仪#R#美工刀#R#斜口钳#R#黄油
KhriNKQxXfks	姓名#R#性别#R#出生日期#R#学院#R#手机号码#R#QQ#R#为什么会考虑加入XX社#R#觉得自己加入XX社的优势#R#对于XX社的看法和建议#R#QQ#R#自我评价#R#意愿部门
eEsmcqFEqmLd	姓名#R#性别#R#出生日期#R#学院#R#手机号码#R#QQ#R#为什么会考虑加入XX社#R#觉得自己加入XX社的优势#R#对于XX社的看法和建议#R#QQ#R#自我评价#R#意愿部门
PoosaRbmgfvT	你的姓名#R#你的手机号码#R#你的出生年月
CSqJYjYEEaaA	姓名#R#部门#R#是否会包饺子#R#想吃什么馅的饺子或汤圆#R#手机号码#R#邮箱#R#课程选择#R#岗位#R#方便参加课程时间#R#近期意向学习内容#R#其他建议
ZnXyPEVhpfUh	姓名#R#学号#R#来参加排练的次数
FotKiaWbyCmI	名字#R#QQ#R#数量
NalQWXWLBTDB	你的姓名#R#是否在星期天早上9点能上线#R#如果你要参加请填写你的ID#R#是否能在明天早上9点上线
TapQIvwLscFw	你的姓名#R#你的手机号码#R#你的性别
MYtlAGuKAbmF	用车申请人#R#申请日期#R#用车原因#R#岗位职级#R#车牌号码#R#用车日期#R#用车路线#R#驾驶员#R#提供的发票金额#R#用车里程数#R#测算出的汽油费#R#过路（桥）费#R#批准用车的项目领导
KxHoEtnvKNvc	你的学历#R#你的手机号码#R#你的姓名#R#你的身份证号码#R#你的邮箱#R#你的性别#R#你的出生年月#R#你的服装尺寸#R#你的性别#R#你的出生年月#R#你的服装尺寸#R#你的学历
WdTrCYLJDItI	学号#R#姓名#R#成绩
IEuzapqtadqa	你的姓名#R#练习时间
YxDKdpvJdJTI	你的UID#R#您的昵称#R#对MIUI的吐槽#R#对MIUI的建议#R#其他
VUbtvBduirtR	岗位职级#R#您的姓名#R#公司/团队名称#R#岗位职级#R#岗位职级#R#联系电话（手机）
OYPuKogEQIgQ	你的姓名#R#你的年龄#R#你的收入#R#已婚未婚#R#职业
FAtjjtfFJjrT	姓名#R#性别#R#出生地#R#籍贯#R#身份证号#R#民族#R#政治面貌#R#户口所在地#R#班内学号#R#班级#R#入学年月#R#入学方式#R#就读方式#R#家庭住址#R#QQ号码#R#家庭成员或监护人信息：姓名#R#关系#R#民族#R#工作单位#R#现住址#R#户口所在地#R#家庭成员或监护人的联系电话（手机）#R#是否为监护人#R#联系电话（手机）#R#QQ号码#R#家庭成员或监护人信息：姓名#R#关系
DeQlogvbGCmW	你的姓名#R#你的姓名
YMkmegzwONTS	姓名#R#性别#R#出生地#R#籍贯#R#身份证号#R#民族#R#政治面貌#R#户口所在地#R#班内学号#R#班级#R#入学年月#R#入学方式#R#就读方式#R#家庭住址#R#QQ号码#R#家庭成员或监护人信息：姓名#R#关系#R#民族#R#工作单位#R#现住址#R#户口所在地#R#家庭成员或监护人的联系电话（手机）#R#是否为监护人#R#联系电话（手机）#R#QQ号码#R#家庭成员或监护人信息：姓名#R#关系
SeWylbekyfND	你的姓名#R#机构代码#R#备案药师代码
UYjDVfYmglnr	姓名#R#性别#R#出生日期#R#学院#R#手机号码#R#QQ#R#为什么会考虑加入XX社#R#觉得自己加入XX社的优势#R#对于XX社的看法和建议#R#QQ#R#自我评价#R#意愿部门
OhDHqieUJzfJ	姓名#R#部门#R#手机号码#R#邮箱#R#课程选择#R#岗位#R#方便参加课程时间#R#近期意向学习内容#R#其他建议
RsHvKructEgM	报修日期#R#预约维护人员#R#电脑型号#R#故障问题#R#电脑位置#R#部门#R#维修类型#R#报修人#R#维护人员#R#故障状态#R#维修结果
FyRPLkOlMBPf	姓名#R#性别#R#出生地#R#籍贯#R#身份证号#R#民族#R#政治面貌#R#户口所在地#R#班内学号#R#班级#R#入学年月#R#入学方式#R#就读方式#R#家庭住址#R#QQ号码#R#家庭成员或监护人信息：姓名#R#关系#R#民族#R#工作单位#R#现住址#R#户口所在地#R#家庭成员或监护人的联系电话（手机）#R#是否为监护人#R#联系电话（手机）#R#QQ号码#R#家庭成员或监护人信息：姓名#R#关系
cxxaPIrNMzBi	choose 10 synonyms of \"abstruse\"#R#choose 10 synonyms of \"altercation\"#R#choose 10 synonyms of \"assauge\"#R#choose 10 synonyms of \"affinity\"#R#choose 10 synonyms of \"callous\"
XbUjPWpjTpnD	姓名#R#性别#R#出生地#R#籍贯#R#身份证号#R#民族#R#政治面貌#R#户口所在地#R#班内学号#R#班级#R#入学年月#R#入学方式#R#就读方式#R#家庭住址#R#QQ号码#R#家庭成员或监护人信息：姓名#R#关系#R#民族#R#工作单位#R#现住址#R#户口所在地#R#家庭成员或监护人的联系电话（手机）#R#是否为监护人#R#联系电话（手机）#R#QQ号码#R#家庭成员或监护人信息：姓名#R#关系
MkDLlgerqCSA	主题清晰度（100分满分）#R#声音洪亮度（100分满分）#R#声音洪亮度（100分满分）#R#表达自信度（100分满分）#R#互动性（100分满分）（眼神互动、邀请听众回答）#R#演讲的吸引力（100分满分）
FooPGpIZYXnC	四季度检查
TPvoZSWMLFWO	王教练#R#学生1#R#学生2
eCmgphdpduMf	姓名#R#性别#R#手机#R#任教学科或任职部门#R#QQ号#R#邮箱地址#R#是否住校#R#出生日期#R#家长姓名#R#家长电话（手机）#R#家庭住址
BDOIWcopaDqT	姓名#R#性别#R#出生日期#R#学院#R#手机号码#R#QQ#R#为什么会考虑加入XX社#R#觉得自己加入XX社的优势#R#对于XX社的看法和建议#R#QQ#R#自我评价#R#意愿部门
Enrxjdwpbmnh	你的姓名#R#你的学号
cWZexHCOteBu	姓名#R#性别#R#出生地#R#籍贯#R#身份证号#R#民族#R#政治面貌#R#户口所在地#R#班内学号#R#班级#R#入学年月#R#入学方式#R#就读方式#R#家庭住址#R#QQ号码#R#家庭成员或监护人信息：姓名#R#关系#R#民族#R#工作单位#R#现住址#R#户口所在地#R#家庭成员或监护人的联系电话（手机）#R#是否为监护人#R#联系电话（手机）#R#QQ号码#R#家庭成员或监护人信息：姓名#R#关系
SuCPFiAvPSfG	你的服装尺寸#R#你的工号#R#你的OA账号
YEJjGvMYtafR	你的网址
RTuYTnncGYjc	你的姓名#R#你的手机号码#R#你的邮寄地址
FIgxfPFhaoZL	姓名#R#性别#R#出生地#R#籍贯#R#身份证号#R#民族#R#政治面貌#R#户口所在地#R#班内学号#R#班级#R#入学年月#R#入学方式#R#就读方式#R#家庭住址#R#QQ号码#R#家庭成员或监护人信息：姓名#R#关系#R#民族#R#工作单位#R#现住址#R#户口所在地#R#家庭成员或监护人的联系电话（手机）#R#是否为监护人#R#联系电话（手机）#R#QQ号码#R#家庭成员或监护人信息：姓名#R#关系
DpYPxguwbzTF	你的姓名#R#你喜欢哪个环节呢？#R#你的姓名#R#你有什么更好地建议提供给我们吗？#R#你为本次活动评多少分呢？（满分100）#R#你的姓名#R#你的性别
CoZsmGqnQXdN	姓名#R#性别#R#手机#R#QQ号#R#微信号#R#是否住校#R#出生日期#R#身份证号码#R#职位名称#R#OA邮箱#R#职位名称#R#家庭住址
EkmNRzRfSiyi	你的姓名
WtFNVFExbqcz	你的姓名#R#问题以及所需要的建议
LluNqJMIFLxc	你的出生年月
PIJTPIHCkDpd	姓名#R#性别#R#出生日期#R#学院#R#手机号码#R#QQ#R#为什么会考虑加入XX社#R#觉得自己加入XX社的优势#R#对于XX社的看法和建议#R#QQ#R#自我评价#R#意愿部门
APxrzLpUTtBU	你的姓名#R#籍贯#R#获得的奖学金#R#获得的奖学金2#R#寒暑期社会实践，名称#R#寒暑社会实践时间#R#寒暑社会实践地点#R#创新创业活动名称，日期，荣誉（一行填一个）#R#参加的文体活动#R#志愿活动1时间#R#志愿活动1名称#R#志愿活动1地点#R#志愿活动2时间#R#志愿活动2名称#R#志愿活动2地点#R#其余志愿活动时间，名称，地点（一行填一个志愿）#R#优秀宿舍奖励#R#获得的荣誉称号等
UXwbPgiIxiSV	日清
IAnjvkSJBTFb	姓名#R#性别#R#出生地#R#籍贯#R#身份证号#R#民族#R#政治面貌#R#户口所在地#R#班内学号#R#班级#R#入学年月#R#入学方式#R#就读方式#R#家庭住址#R#QQ号码#R#家庭成员或监护人信息：姓名#R#关系#R#民族#R#工作单位#R#现住址#R#户口所在地#R#家庭成员或监护人的联系电话（手机）#R#是否为监护人#R#联系电话（手机）#R#QQ号码#R#家庭成员或监护人信息：姓名#R#关系
KXSZsKzmsizE	日期#R#销售/BD姓名#R#拜访商家名称#R#商家地点#R#隶属公司#R#商家等级#R#KP（关键人）#R#KP联系电话#R#跟进状态#R#未签约原因
UfKUvzHbwNtQ	问题标题17.1535515719
UAbEKMJPGvhB	你的姓名
SEpoyiOxzJjA	您要提的意见及建议，如需要我答复的请留下名字，不需要我答复的匿名即可。#R#对目前班级工作满意度
bgXQmggANHLg	姓名#R#性别#R#出生地#R#籍贯#R#身份证号#R#民族#R#政治面貌#R#户口所在地#R#班内学号#R#班级#R#入学年月#R#入学方式#R#就读方式#R#家庭住址#R#QQ号码#R#家庭成员或监护人信息：姓名#R#关系#R#民族#R#工作单位#R#现住址#R#户口所在地#R#家庭成员或监护人的联系电话（手机）#R#是否为监护人#R#联系电话（手机）#R#QQ号码#R#家庭成员或监护人信息：姓名#R#关系
bjEbVCijdrBx	姓名#R#性别#R#出生地#R#籍贯#R#身份证号#R#民族#R#政治面貌#R#户口所在地#R#班内学号#R#班级#R#入学年月#R#入学方式#R#就读方式#R#家庭住址#R#QQ号码#R#家庭成员或监护人信息：姓名#R#关系#R#民族#R#工作单位#R#现住址#R#户口所在地#R#家庭成员或监护人的联系电话（手机）#R#是否为监护人#R#联系电话（手机）#R#QQ号码#R#家庭成员或监护人信息：姓名#R#关系
IXZZOdFQixHZ	姓名#R#性别#R#手机#R#QQ号#R#微信号#R#是否住校#R#出生日期#R#家长姓名#R#家长电话（手机）#R#家庭住址
DJzZrrxNqQVf	姓名#R#性别#R#单位（用别字，注意敏感性）#R#类型#R#手中型号#R#需要型号#R#政治面貌#R#户口所在地#R#班内学号#R#班级#R#入学年月#R#入学方式#R#就读方式#R#家庭住址#R#QQ号码#R#家庭成员或监护人信息：姓名#R#关系#R#民族#R#工作单位#R#现住址#R#户口所在地#R#家庭成员或监护人的联系电话（手机）#R#是否为监护人#R#联系电话（手机）#R#QQ号码#R#家庭成员或监护人信息：姓名#R#关系
SehapWHcLqfl	你的服装尺寸#R#你的性别#R#你的性别#R#你的网址#R#你的出生年月#R#你的学历#R#你的手机号码#R#你的身份证号码#R#你的姓名#R#你的邮箱
fHyHePOKOYxL	姓名#R#部门#R#手机号码#R#邮箱#R#课程选择#R#岗位#R#方便参加课程时间#R#观影人数#R#其他建议
HDLBqWmFqScT	出行人中文名#R#出行人英文名#R#出行人英文名
LGCrnJeKmHhO	姓名（中英）#R#性别#R#校区#R#生日#R#星座#R#电话#R#邮箱#R#户口所在地#R#班内学号#R#班级#R#入学年月#R#入学方式#R#就读方式#R#家庭住址#R#QQ号码#R#家庭成员或监护人信息：姓名#R#关系#R#民族#R#工作单位#R#现住址#R#户口所在地#R#家庭成员或监护人的联系电话（手机）#R#是否为监护人#R#联系电话（手机）#R#QQ号码#R#家庭成员或监护人信息：姓名#R#关系
MWsljmeUQAGb	主题清晰度（100分满分）#R#声音洪亮度（100分满分）#R#表达自信度（100分满分）#R#演讲形象（100满分）（站姿、眼神）#R#互动性（100分满分）（眼神互动、邀请听众回答）#R#演讲的吸引力（100分满分）
EISgxBNcDuuT	姓名#R#性别#R#手机#R#QQ号#R#微信号#R#是否住校#R#出生日期#R#家长姓名#R#家长电话（手机）#R#家庭住址
GEhfpVzXvXvR	您的姓名#R#岗位职级#R#岗位职级#R#联系电话（手机）
ehCaxerYAuXc	姓名#R#性别#R#手机#R#QQ号#R#微信号#R#是否住校#R#出生日期#R#家长姓名#R#家长电话（手机）#R#家庭住址
AdBZpJNdiSsR	姓名#R#性别#R#出生地#R#籍贯#R#身份证号#R#民族#R#政治面貌#R#户口所在地#R#班内学号#R#班级#R#入学年月#R#入学方式#R#就读方式#R#家庭住址#R#QQ号码#R#家庭成员或监护人信息：姓名#R#关系#R#民族#R#工作单位#R#现住址#R#户口所在地#R#家庭成员或监护人的联系电话（手机）#R#是否为监护人#R#联系电话（手机）#R#QQ号码#R#家庭成员或监护人信息：姓名#R#关系
ECKMgARTpvkN	你的姓名
dQygobksauWX	商品免单序号#R#商品名称#R#商品订单号#R#提交者姓名#R#备注
ayuRjomPSZvg	姓名#R#性别#R#手机#R#QQ号#R#微信号#R#是否住校#R#出生日期#R#家长姓名#R#家长电话（手机）#R#家庭住址
fQrnsLJlrBmO	你的姓名#R#你的性别#R#最能代表杭州点文化#R#最能代表杭州特色的文化街区是什么#R#您是否能经常看到杭州历史文化相关的宣传吗#R#你认为杭州的历史文化开发还可以如何改进#R#哪些词能概括对杭州的印象
WePbxKjbuOqo	你的姓名#R#你的手机号码#R#你的邮箱
dwRtlAexbubm	姓名#R#性别#R#手机#R#QQ号#R#微信号#R#是否住校#R#出生日期#R#家长姓名#R#家长电话（手机）#R#家庭住址#R#你的服装尺寸
NxEajAjPaveC	您的姓名#R#公司/团队名称#R#岗位职级#R#岗位职级#R#联系电话（手机）
fUyPtAMerYab	你的姓名#R#你的学号#R#本门选修课共4次课，你一共来参加过几次课？#R#你最喜欢本门课程的哪一部分的内容？#R#你对本门课程的内容设置有何建议？#R#你对本门课程上课老师有何建议？#R#如果你自己给自己打分，你觉得本门课程成绩是多少？#R#观看了《国王的演讲》后，请你从心理咨询的视角谈谈你对这部影片的感悟和收获。#R#字数150字以上)
ZhVJRvwOQlNA	你的姓名#R#你的邮箱#R#你的性别#R#你的学历#R#制作简介
UfkqMCkYXZhj	宿舍号#R#宿舍问题描述（要求：简洁易懂）#R#预约时间（几月几号上午或下午宿舍有人）#R#报修时间（几月几号报修）#R#联系电话#R#报修人
ZIQQYOrAJPVO	学生姓名#R#成员一姓名#R#成员一身份证#R#成员二姓名#R#成员二身份证号#R#成员一与学生关系#R#成员二与学生关系
QdiUQFvUUUOS	姓名#R#性别#R#手机#R#QQ号#R#微信号#R#是否住校#R#出生日期#R#家长姓名#R#家长电话（手机）#R#家庭住址
bQfDXOdwchWn	姓名#R#性别#R#手机#R#QQ号#R#微信号#R#是否住校#R#出生日期#R#家长姓名#R#家长电话（手机）#R#家庭住址
apFrChNaegUm	你的姓名#R#生源地#R#贷款#R#组织
DHjeTMlaGZDp	姓名#R#性别#R#身份证号码
aUiSmsWcbLgm	ID#R#时间#R#编号
HqiEyInHbbdh	你的手机号码
CyOtcATVaxme	你的微信昵称-下单价格#R#你下的免单是#R#谁送你的免单#R#订单编号#R#下单日期
KlrkgaTvGtGf	您的姓名#R#公司/团队名称#R#岗位职级#R#岗位职级#R#联系电话（手机）
PcscXDYzoJYS	姓名#R#性别#R#手机#R#QQ号#R#微信号#R#是否住校#R#出生日期#R#家长姓名#R#家长电话（手机）#R#家庭住址
CPyzoFxzYWex	你的姓名#R#你的性别#R#对学习态度#R#兴趣爱好
enDqjFIEwwCg	你的姓名#R#你的手机号码#R#你的身份证号码#R#支付宝账号
MjgvslfsBFnO	主题清晰度（100分满分）#R#声音洪亮度（100分满分）#R#表达自信度（100分满分）#R#演讲形象（100满分）（站姿、眼神）#R#互动性（100分满分）（眼神互动、邀请听众回答）#R#演讲的吸引力（100分满分）
EAMUiuGosEOo	姓名#R#性别#R#出生地#R#籍贯#R#身份证号#R#民族#R#政治面貌#R#户口所在地#R#班内学号#R#班级#R#入学年月#R#入学方式#R#就读方式#R#家庭住址#R#QQ号码#R#家庭成员或监护人信息：姓名#R#关系#R#民族#R#工作单位#R#现住址#R#户口所在地#R#家庭成员或监护人的联系电话（手机）#R#是否为监护人#R#联系电话（手机）#R#QQ号码#R#家庭成员或监护人信息：姓名#R#关系
TaONDHGudNui	姓名#R#性别#R#出生地#R#籍贯#R#身份证号#R#民族#R#政治面貌#R#户口所在地#R#班内学号#R#班级#R#入学年月#R#入学方式#R#就读方式#R#家庭住址#R#QQ号码#R#家庭成员或监护人信息：姓名#R#关系#R#民族#R#工作单位#R#现住址#R#户口所在地#R#家庭成员或监护人的联系电话（手机）#R#是否为监护人#R#联系电话（手机）#R#QQ号码#R#家庭成员或监护人信息：姓名#R#关系
KZmCsdkNtvqV	小面包 4元/串#R#韭菜 2元/串#R#金针菇 2元/串#R#肉圆 2元/串#R#烤面筋 2元/串#R#五花肉 4元/串#R#热狗 3元/串#R#大肉串 3元/串#R#小青椒 2元/串#R#大豆干（3片/串） 4元/串#R#纯肉肠 5元/串#R#雪花肉串 4元/串#R#火龙串 3元/串#R#火腿肠 3元/串#R#腊肠 3元/串#R#羊肉串 3元/串#R#牛肉串/羊肉串 3元/串#R#里脊肉 3元/串#R#鸡爪 6元/2只#R#中翅 6元/串#R#大鸡翅 7元/串#R#里脊肉 3元/串#R#秋刀鱼 7元/串#R#骨肉相连 3元/串#R#牛肉串串（30串/份） 15元/份#R#大鱿鱼 10元/串 #R#小鱿鱼 3元/串#R#牛肉串串
TTlFaILQubkQ	姓名#R#性别#R#手机#R#QQ号#R#工作单位#R#业务范围#R#是否住校#R#出生日期#R#家长姓名#R#家长电话（手机）#R#家庭住址
NbCEdukFwAGk	姓名#R#性别#R#手机#R#QQ号#R#微信号#R#是否住校#R#出生日期#R#家长姓名#R#家长电话（手机）#R#家庭住址
VPVdamsqviSv	日期#R#销售/BD姓名#R#拜访商家名称#R#商家地点#R#隶属公司#R#商家等级#R#KP（关键人）#R#KP联系电话#R#跟进状态#R#未签约原因
GrlTfnrevykP	你的小孩姓名#R#优点#R#缺点
dAZIZImApYrw	专业#R#班级#R#姓名#R#性别#R#学号
KbXSPxaEVQJq	你的手机号码
CRQuijKZSZIR	你的姓名
HgwfwxjFwrOC	投票科室#R#投票日期#R#投票数#R#负责人
RncCTZVuURCR	你的姓名#R#你的手机号码#R#你的身份证号码
OijGmILKmyOq	传奇口红#R#羽绒服#R#地址信息收集#R#你的身份证号码#R#你的服装尺寸#R#地址收集#R#羽绒服
YpjhpsOLzpQC	你的姓名#R#你的手机号码#R#你的身份证号码#R#你的邮箱#R#你的邮箱#R#你的性别#R#你的服装尺寸#R#你的学历
TEpAbgQsrjnn	姓名#R#学号#R#专业#R#专业#R#你的性别
dIVJKEpifDNQ	姓名#R#性别#R#出生地#R#籍贯#R#身份证号#R#民族#R#政治面貌#R#户口所在地#R#班内学号#R#班级#R#入学年月#R#入学方式#R#就读方式#R#家庭住址#R#QQ号码#R#家庭成员或监护人信息：姓名#R#关系#R#民族#R#工作单位#R#现住址#R#户口所在地#R#家庭成员或监护人的联系电话（手机）#R#是否为监护人#R#联系电话（手机）#R#QQ号码#R#家庭成员或监护人信息：姓名#R#关系
ddSDEtjSSIpH	未命名的标题
abssQSZcLQcf	你的学历#R#你的网址#R#你的出生年月#R#你的服装尺寸
SZtPmwpaVuZm	队员1 学院#R#队员1 班级#R#队员1 姓名#R#队员1 学号#R#队员1 电话号码#R#队员1 QQ#R#队员1 民生银行卡卡号#R#队员1 备注 #R#队员2 学院#R#队员2 班级#R#队员2 姓名#R#队员2 学号#R#队员2 电话号码#R#队员2 QQ#R#队员2 民生银行卡卡号#R#队员2 备注#R#队员3 学院#R#队员3 班级#R#队员3 姓名#R#队员3 学号#R#队员3 电话号码#R#队员3 QQ#R#队员3 民生银行卡卡号#R#队员3 备注
fUJlGCRBWEXh	你的姓名#R#你的手机号码
PRmQsHsjOMnq	未命名的标题
AhdkgeUBdTiZ	你的姓名#R#你的学号#R#你要买什么书
LNqpggiULubz	姓名#R#学号#R#性别#R#联系方式#R#申请组别#R#才艺组申请节目#R#游戏组申请游戏#R#圣诞老人的身高体重？（格式：身高+体重；单位：cm\u0026kg）
GfXjCPpiNOcO	姓名#R#性别#R#出生日期#R#QQ号码#R#手机号码#R#QQ#R#为什么会考虑加入本平台#R#觉得自己加入XX社的优势#R#对于本平台的看法和建议#R#QQ#R#自我评价#R#意愿部门
bSQGLEiuQzYL	你的姓名#R#你的手机号码#R#你的邮箱#R#你的性别#R#你的出生年月#R#你的性别#R#你的学历#R#你的手机号码
biGdIVPdwESN	请填写你的县市区和姓名，以“XX县市区，姓名”的格式#R#经济普查的对象包括哪三类对象？#R#从行业范围看，经济普查的对象包括实际从事第二产业、第三产业经济活动的单位。#R#下面关于个体经营户的说法正确的是： #R#普查员根据单位划分规定，可以确定下面哪些内容：#R#普查员根据普查表中填报的机构类型、单位类型等有关指标内容，综合确定下面哪项内容：#R#根据普查表中填报的机构类型、单位类型等有关指标内容，综合确定各项专业普查表如何分配和部署。#R#普查员根据单位划分规定，确定应为被调查对象布置哪种类型的普查表，以及被调查对象如何准确填报普查表中有关单位类型的指标。#R#在经济普查中，法人单位需要同时满足以下三个条件，缺一不可：#R#法人单位包括下列哪几种基本类型#R#公司制企业法人指依据《中华人民共和国公司登记管理条例》核准登记注册的企业。公司制企业是现代企业制度的主要组织形式，分为#R#国有独资公司是_________或者_________单独投资设立的有限责任公司（不包括国有控股的有限责任公司）。#R#普查员入户清查时，可根据被调查对象营业执照上哪些字样识别哪些单位类型？#R#未命名的标题#R#普查员根据下列哪些证照认定企业法人#R#入户实际经营地A，调查发现该单位为一家饭店，营业执照显示该单位为法人单位，但登记注册地址在另外一个地点C。应由__________所在普查小区的普查员调查登记。#R#入户实际经营地B，发现该单位为一家咖啡店，调查发现该单位为实际经营地A总店的分店，且符合产业活动单位的条件，确定为产业活动单位。这种情况应如何填表？#R#垂直管理机构认定视同法人单位涉及行业领域仅限于#R#普查方案中规定的石油系统只有下列单位的地市级分支机构可以被视同法人，其他石油单位的分支机构均不能视同法人#R#母公司与子公司、总公司与分公司的说法正确的是#R#企业法人名称中带有下列哪些字样的单位一般是分支机构，可作为产业活动单位，但符合特殊规定的企业法人除外。#R#我国的大部分事业单位大都分布在公益性领域，大多不以营利为目的，下列单位中属于事业单位的有：#R#下列单位中属于机关法人单位的有：#R#关于社会团体，下面说法合理的是#R#其他法人是指除企业法人、事业单位法人、机关法人及社会团体法人以外的其他符合法人单位条件的单位，包括下列#R#需要普查员识别的产业活动单位主要分为两类：一类是依法成立的分支机构，一类是未经法定程序批准设立的其他产业活动单位。产业活动单位必须满足下面哪些条件#R#现实中的产业活动单位以下面哪些形式存在#R#未经法定程序批准设立的其他产业活动单位，主要通过判断行业范围和地域范围来确定。下面说明中的例子，是否是产业活动单位#R#有两处或两处以上社会经济活动所在地（实际经营地、实际运营地等）的普查对象（非建筑业）应如何登记？
cbCHTskQDiiL	灭火器箱#R#灭火球#R#防毒面具#R#灭火毯#R#二手灭火器#R#你的姓名#R#你的手机号码#R#铺位#R#全新灭火器
HOThHylxGfal	姓名#R#性别#R#出生日期#R#学院#R#手机号码#R#QQ#R#为什么会考虑加入XX社#R#觉得自己加入XX社的优势#R#对于XX社的看法和建议#R#QQ#R#自我评价#R#意愿部门
XujzJeiXcJub	姓名#R#性别#R#出生地#R#籍贯#R#身份证号#R#民族#R#政治面貌#R#户口所在地#R#班内学号#R#班级#R#入学年月#R#入学方式#R#就读方式#R#家庭住址#R#QQ号码#R#家庭成员或监护人信息：姓名#R#关系#R#民族#R#工作单位#R#现住址#R#户口所在地#R#家庭成员或监护人的联系电话（手机）#R#是否为监护人#R#联系电话（手机）#R#QQ号码#R#家庭成员或监护人信息：姓名#R#关系
HagoCeqkQMWS	乔玉山
JcnUKuebwpYB	你的姓名#R#你的手机号码
